aaa	GHOTUO
aab	TESU
aac	ARI
aad	AMAL
aah	ABU_ARAPESH
aak	ANKAVE
aal	AFADE
aan	ANAMBE
aao	SAHARAN_ARABIC
aap	ARARA_DO_PARA
aaq	ABNAKI_EASTERN
aar	AFAR
aas	AASAX
aau	ABAU
aaw	ARAWE
aax	KAETI_DUMUT
aba	ABE
abb	BANKON
abd	MANIDE
abe	ABNAKI_WESTERN
abg	ABAGA
abh	TAJIKI_ARABIC
abi	ABIDJI
abj	AKA_BEA
abk	ABKHAZ
abm	ABANYOM
abn	ABUA
abo	ABON
abp	AYTA_ABELLEN
abq	ABAZA
abr	ABRON
abs	AMBONESE_MALAY
abt	AMBULAS
abu	ABURE
abv	BAHRAIN_ARABIC
abw	ABASAKUR
abx	INABAKNON
aby	ANEME_WAKE
abz	ABUI
aca	ACHAGUA
acd	GIKYODE
ace	ACEH
acf	ST_LUCIAN_CREOLE_FRENCH
ach	ACHOLI
aci	AKA_CARI
ack	AKA_KORA
acl	AKAR_BALE
acn	ACHANG
acp	SEGEMUK
acu	ACHUAR
acv	ACHUMAWI
acw	HIJAZI_ARABIC
acy	ARABIC_CYPRIOT_SPOKEN
ada	DANGME
add	DZODINKA
ade	ADELE
adf	DHOFARI_ARABIC
adh	ADHOLA
adj	ADIOUKROU
adl	GALO
adn	ADANG
ado	ABU
adq	ADANGBE
adt	ADNYAMATHANHA
adw	AMONDAVA
adx	MAQU_TIBETAN
ady	ADYGHE
adz	ADZERA
aeb	TUNISIAN_ARABIC_MAGHRIB
ael	AMBELE
aer	ARRERNTE_EASTERN
aes	ALSEA
aew	AMBAKICH
aey	AMELE
aez	AEKA
afd	ANDAI
afe	PUTUKWAM
afi	AKUKRAY
afn	DEFAKA
afo	ELOYI
afp	TAPEI
afr	AFRIKAANS
aft	AFITTI
afu	EFUTU
afz	OBOKUITAI
agb	LEGBO
agd	AGARABI
age	ANGAL
agf	ARGUNI
agg	ANGOR
agh	NGELIMA
agj	ARGOBBA
agl	AGALA
agm	ANGAATAHA
ago	TAINAE
agq	AGHEM
agr	AGUARUNA
ags	ESIMBI
agt	AGTA
agv	SINAUNA
agw	KAHUA
agx	AGUL
agy	ALTA_SOUTHERN
aha	AHANTE
ahb	AXAMB
ahg	KEMANT
ahh	AGHU
ahi	AIZI_TIAGBAMRIN
ahk	AKHA
ahl	AHLO
ahn	AHAN
aho	AHOM
ahp	AIZI
ahs	ITOO
aib	AYNU
aie	AMARA
aif	AGI
aih	TAIYANG_AI_CHAM
aik	AKE
ail	AIMELE
aim	AIMOL
aip	BURUMAKOK
air	AIRORAN
ait	ARIKEM
aiw	ARI
aiy	ALI
aja	AJA
ajg	AJA
aji	AJIE
aju	JUDEO_MOROCCAN_ARABIC
ajz	AMRI_KARBI
akb	BATAK_ANGKOLA
akc	MPUR
akd	UKPET_EHOM
ake	AKAWAIO
akg	ANAKALANG
akh	ANGAL_HENENG
aki	AIOME
akk	AKKADIAN
akl	AKLANON
akm	AKA_BO
akp	SIWU
akq	AK
akr	ARAKI
aks	AKASELEM
akt	AKOLET
aku	AKUM
akv	AKHVAKH
akw	AKWA
akx	AKA_KEDE
aky	AKA_KOL
akz	ALABAMA
ala	ALAGO
alc	QAWASQAR
ald	ALLADIAN
ale	ALEUT
alf	ALEGE
alh	ALAWA
ali	AMAIMON
alk	ALAK
alm	AMBLONG
aln	ALBANIAN_GHEG
alo	LARIKE_WAKASIHU
alp	ALUNE
alq	ALGONQUIN
alr	ALUTOR
als	ALBANIAN_TOSK
alt	ALTAI
alw	ALAABA
alz	ALUR
ama	AMANAYE
amc	AMAHUACA
ame	AMUESHA
amf	HAMER_BANNA
amg	AMURDAK
amh	AMHARIC
amj	AMDANG
amk	AMBAI
aml	WAR_JAINTIA
amm	AMA
amn	AMANAB
amo	AMO
amp	ALAMBLAK
amq	AMAHAI
amr	AMARAKAERI
amt	AMTO
amu	XOCHISTLAHUACA_AMUZGO
amw	WESTERN_NEO_ARAMAIC
amx	ANMATYERRE
amy	AMI
ana	ANDAQUI
anb	ANDOA
and	ANSUS
ane	XARACUU
anf	ANIMERE
ang	OLD_ENGLISH
anh	NEND
ani	ANDI
anj	ANOR
ank	GOEMAI
anl	HKONGSO
anm	ANAL
ann	OBOLO
ano	ANDOQUE
anp	ANGIKA
anq	JARAWA
anu	ANYUAK
anw	ANAANG
anx	HUS
anz	ANEM
aoa	ANGOLAR
aob	ABOM
aoc	PEMON
aod	ANDARUM
aoe	NEMBI
aof	BRAGAT
aog	ANGORAM
aoi	INGURA
aoj	MUFIAN
aol	ALOR
aom	OMIE
aor	AORE
aos	TAIKAT
aot	A_TONG
aoz	UAB_METO
apb	SAA
apd	SUDANESE_ARABIC
ape	BUKIYIP
aph	ATHPARE
api	APIAKA
apj	JICARILLA_APACHE
apk	KIOWA_APACHE
apl	LIPAN
apm	CHIRICAHUA
apn	APINAYE
app	APMA
apq	SOUTH_ANDAMAN
apr	AROP_LOKEP
aps	AROP_SISSANO
apt	APATANI
apu	APURINA
apw	SAN_CARLOS
apx	APUTAI
apy	APALAI
apz	AMPALE
aqc	ARCHI
aqd	AMPARI_PA
aqg	ARIGIDI
aqm	ATOHWAIM
aqn	ALTA_NORTHERN
aqp	ATAKAPA
aqt	SANAPANA_ANGAITE
aqz	AKUNTSU
arb	STANDARD_ARABIC
ard	ARABANA
are	ARRARNTA_WESTERN
arg	ARAGONESE
arh	IKA
ari	ARIKARA
ark	ARIKAPU
arl	ARABELA
arn	MAPUDUNGUN
aro	ARAONA
arp	ARAPAHO
arq	DELLYS
arr	KARO_BRAZIL
ars	NAJDI_ARABIC
arv	ARBORE
arw	LOKONO
ary	MOROCCAN_ARABIC
arz	CAIRO_ARABIC
asa	ASU_TANZANIA
asb	ASSINIBOINE
asc	CASUARINA_COAST_ASMAT
asg	CISHINGINI
asi	ASIENARA
asj	SARI
ask	ASHKUN
asl	ASILULU
asm	ASSAMESE
asn	ASURINI_XINGU
aso	DANO
ass	IPULO
ast	ASTURIAN
asu	ASURINI
asv	ASOA
asx	MURATAYAK
asy	ASMAT_YAOSAKOR
asz	AS
ata	PELE_ATA
atb	ZAIWA
atd	MANOBO_ATA
ate	ATEMPLE
ati	ATTIE
atj	ATIKAMEKW
atk	SOGODNIN_BORACAY
atr	WAIMIRI_ATROARI
ats	GROS_VENTRE
att	ATTA_PAMPLONA
atu	REEL
atv	NORTH_ALTAI
atw	ATSUGEWI
atx	AWAKE
atz	ARTA
aua	ASUMBOA
auc	WAORANI
aud	ANUTA
auh	AUSHI
aui	ANUKI
auj	AWJILAH
auk	HEYO
aul	AULUA
aum	ASU_NIGERIA
aun	MOLMO_ONE
aup	MAKAYAM
aur	ARUEK
aut	RURUTUAN
auu	AUYE
auw	AWJI
auy	AUYANA
avb	AVAU
ave	AVESTAN
avi	AVIKAM
avl	EASTERN_EGYPTIAN_BEDAWI_ARABIC
avn	SIDEME
avt	AU
avu	AVOKAYA
avv	AVA_CANOEIRO
awa	AWADHI
awb	AWA
awc	CICIPU
awe	AWETI
awg	ANGUTHIMRI
awh	AWBONO
awi	AEKYOM
awk	AWABAKAL
awm	ARAWUM
awn	AWNGI
awo	AWAK
awr	AWERA
aws	SIAGHA
awt	ARAWETE
awv	JAIR_AWYU
aww	AWUN
awx	AWARA
awy	SJIAGHA
axb	ABIPON
axk	YAKA_axk
aya	AWAR
ayb	AYIZO_GBE
ayc	SOUTHERN_AYMARA
aye	AYERE
ayg	GENYANGA
ayh	HADRAMI_ARABIC
ayi	LEYIGHA
ayn	YEMEN_SANAANI_ARABIC
ayo	AYOREO
ayp	NORTH_MESOPOTAMIAN_ARABIC
ayr	CENTRAL_AYMARA
ayu	AYU
ayz	MAI_BRAT
azb	AZERBAIJANI_SOUTHERN
azg	SAN_PEDRO_AMUZGOS_AMUZGO
azj	AZERBAIJANI_NORTH
azn	NAHUATL_SAN_AGUSTIN_DE_BUENAVENTURA
azo	AWING
azz	HIGHLAND_PUEBLA_NAHUATL
bae	BARE
baf	NUBACA
bag	TUKI
bak	BASHKIR
bam	BAMBARA
ban	BALI
bao	WAIMAHA
bap	BANTAWA
bar	BAVARIAN_GERMAN
bas	BASAA
bau	BADA
bav	VENGO
baw	BAMBILI
bax	BAMUN
bay	BATULEY
bba	BAATONUM
bbb	BARAI
bbc	TOBA_BATAK
bbd	BAU
bbe	BANGBA
bbf	BAIBAI
bbg	VARAMA
bbh	BUGAN
bbi	BAROMBI
bbk	BABANKI
bbl	BATS
bbm	BABANGO
bbn	BALI_VITU
bbo	NORTHERN_BOBO_MANDARE
bbr	GIRAWA
bbs	BAKPINKA
bbt	MBURKU
bbu	KULUNG_NIGERIA
bbv	BARIM
bbw	BABA
bby	MODELE
bcc	SOUTHERN_BALOCHI
bcd	NORTH_BABAR
bce	BAMENYAM
bcf	BAMU
bcg	BAGA_MBOTENI
bch	BARIAI
bci	BAULE
bcj	BARDI
bck	BUNABA
bcm	BANONI
bcn	BALI_NIGERIA
bco	KALULI
bcs	KOHUMONO
bct	BENDI
bcu	BILIAU
bcw	BANA
bcy	BACAMA
bcz	BAINOUK_GUNYAAMOLO
bda	BAYOT
bdd	BUNAMA
bde	BADE
bdf	BIAGE
bdg	BONGGI
bdh	BAKA_SUDAN
bdi	BURUN
bdj	BAI
bdk	BUDUKH
bdl	INDONESIAN_BAJAU
bdm	BUDUMA
bdo	MOROM
bdp	BENDE
bdq	BAHNAR
bdr	BAJAU_WEST_COAST
bds	BURUNGE
bdt	BOKOTO
bdu	OROKO
bdw	MBAHAM
bdx	BUDONG_BUDONG
bdy	WAALUBAL
bea	BEAVER
bed	YARIK
bee	BYANSI
bef	BENABENA
beg	BELAIT
beh	BIALI
bei	BEKATI
bej	BEJA
bek	BEBELI
bel	BELARUSIAN
bem	BEMBA
ben	BENGALI
beq	BEEMBE
bes	BESME
bet	BETE_GUIBEROUA
beu	BLAGAR
bev	BETE_DALOA
bew	BETAWI
bex	MODO
bey	BELI
bez	BENA
bfb	PAURI_BARELI
bfd	BAFUT
bfe	BETAF
bff	BOFI
bfh	BLAFE
bfj	BAFANJI
bfm	MMEN
bfn	BUNAQ
bfp	BEBA
bfq	BADAGA
bfu	BUNAN
bfw	REMO
bfy	BAGHELI
bfz	PAHARI_MAHASU
bga	GWAMHI_WURI
bgc	HARYANVI
bgf	BANGANDU
bgg	BUGUN
bgj	BANGOLAN
bgk	BIT
bgn	BALOCHI_WESTERN
bgo	BAGA_KOBA
bgp	BALOCHI_EASTERN
bgq	BAGRI
bgr	BAWM
bgs	TAGABAWA
bgt	BUGHOTU
bgu	MBONGNO
bgv	WARKAJ
bgw	BHATRI
bgz	BANGGAI
bhc	BIGA
bhd	BHADRAWAHI
bhg	BINANDERE
bhj	BAHING
bhl	BIMIN
bho	BHOJPURI
bhp	BIMA
bhq	TUKANG_BESI_SOUTHERN
bhr	MALAGASY_BARA
bhs	BUWAL
bht	BHATTIYALI
bhw	BIAK
bhz	BADA_INDONESIA
bia	BADIMAYA
bib	BISA
bid	BIDIYA
bie	BEPOUR
bif	BIAFADA
big	BIANGAI
bil	BILE
bim	BIMOBA
bin	EDO
bio	NAI
bip	BIRA_BIP
biq	BIPI
bir	BIKARU
bis	BISLAMA
bit	BERINOMO
biv	BIRIFOR_SOUTHERN
biw	KOL
biy	BIRHOR
biz	BALOI
bjb	BANGGARLA
bjc	BARIJI
bje	SHUANGLONG_MIEN
bjh	BAHINEMO
bji	BURJI
bjk	BAROK
bjn	BANJARESE_MALAY
bjo	YAKPA
bjr	BINUMARIEN
bjt	BALANTA_GANJA
bjv	BEJOND
bjw	BAKWE
bjy	BAYALI
bjz	TAFOTA_BARUGA
bka	KYAK
bkc	BAKA
bkd	BINUKID
bkh	BAKOKO
bki	BAKI
bkj	PANDE
bkk	BROKSKAT
bkm	KOM
bkn	BUKITAN
bko	KWA_CAMEROON
bkp	BOKO_DRC
bkq	BAKAIRI
bks	NORTHERN_SORSOGON
bkv	BEKWARRA
bkw	BEKWEL
bkx	BAIKENO
bky	BOKYI
bla	BLACKFOOT
blb	BILUA
blc	BELLA_COOLA
ble	BALANTA_KENTOHE
blf	BUOL
blh	KUWAA
bli	BOLIA
blj	BOLONGAN
blk	KAREN_PAO
bll	BILOXI
blm	JUR_BELI_WULU
bln	SOUTHERN_CATANDUANES
blo	ANII
blp	BLABLANGA
blq	BALUAN_PAM
blr	PLANG
bls	BALAESANG
blt	BLACK_THAI
blv	BOLO
blw	BALANGAW
bly	NOTRE
bma	LAME
bmb	BEMBE
bmc	BIEM
bmd	BAGA_MADURI
bme	LIMASSA
bmf	BOM_SIERRA_LEONE
bmg	BAMWE
bmh	BEMAL
bmi	BAGIRMI
bmn	BINA
bmo	BAMBALANG
bmq	BOMU
bmr	MUINANE
bms	BILMA_KANURI
bmv	BUM
bmw	BOMWALI
bmx	BAIMAK
bmz	BARAMU
bna	BONERATE
bnd	ELAT_KEI_BESAR
bnf	MASIWANG
bng	BENGA
bni	BANGI
bnl	BOON
bnm	BATANGA
bnn	BUNUN
bno	BANTON_BANTOANON
bnp	BOLA
bnq	BANTIK
bns	BUNDELI
bnw	BISIS
bnx	BANGUBANGU
bny	BINTULU
bnz	BEEZEN
boa	BORA
bob	AWEER
boe	MUNDABLI
bof	BOLON
boh	BOMA
boi	CHUMASH_BARBARENO
boj	BOM
bok	IMPFONDO
bol	BOLE
boo	BOZO_TIEMA_CIEWE
boq	BOGAYA
bor	BORORO
bos	BOSNIAN
bot	BONGO
bou	BONDEI
bov	TUWULI
bow	REMA
box	BWAMU
boy	BODO
bpd	BANDA_BANDA
bpg	BONGGO
bph	BOTLIKH
bpi	BAGUPI
bpm	BIYOM
bpn	DAPING_MIEN
bpp	KAURE
bpr	BILAAN_KORONADAL
bps	BILAAN_SARANGANI
bpu	BONGU
bpv	MARIND_BIAN
bpw	BO
bqa	TCHUMBULI
bqb	BAGUSA
bqc	BOKO
bqg	BAGO_KUSUNTU
bqi	BAKHTIARI
bqj	BANDIAL
bql	BILAKURA
bqm	WUMBOKO
bqo	BALO
bqp	BUSA
bqq	BIRITAI
bqr	BURUSU
bqt	BAMUKUMBIT
bqv	BEGBERE_EJAR
bqw	BURU
bqz	BAKAKA
brb	LAVEH
brc	BERBICE_DUTCH_CREOLE
bre	BRETON
brf	BIRA
brg	BAURE
brh	BRAHUI
bri	MOKPWE
brj	BIERIA_VOVO
brk	BIRKED
brm	BARAMBU
brn	BORUCA
brp	BARAPASI
brq	BRERI
brr	MBIRAO
brt	NJWANDE
bru	BRU
brv	BRU_WESTERN_UnnamedInSource
brx	BODO_INDIA
bry	BURUI
brz	BILBIL
bsa	ABINOMN
bsb	BISAYA_BRUNEI
bsc	BASSARI
bse	WUSHI
bsf	MADAKA
bsg	BASHKARDI
bsh	EASTERN_KATIVIRI
bsi	MIENGE
bsk	BURUSHASKI
bsm	BUSAMI
bsn	BARASANO
bsp	BAGA_SITEMU
bsq	BASSA
bsr	BASSA_KONTAGORA
bst	BASKETO
bsw	BAISO
bsx	YANGKAM
bsy	BISAYA_SABAH
btd	BATAK_DAIRI
bte	GAMO_NINGI
btf	BIRGIT
bth	BIATAH_BIDAYUH
bti	BURATE
btj	BACANESE_MALAY
btm	BATAK_MANDAILING
btn	RATAGNON
bto	IRIGA
btr	BAETORA
bts	BATAK_SIMALUNGEN
btw	BUTUANON
btx	KARO_BATAK
bty	BOBOT
btz	BATA_ALAS_KLUET
bub	BUA
buc	BUSHI
bud	BASSARI
bue	BEOTHUK
buf	BUSHOONG
bug	BUGINESE
buh	YOUNUO_BUNU
buk	BUGAWAC
bul	BULGARIAN
bum	BULU
bun	SHERBRO
buo	BUIN
bup	BUSOA
buq	BUNABUN
bus	BOKOBARU
but	BUNGAIN
buu	BUDU
buv	BUN
bux	BOGHOM
bva	BAREIN
bvb	BUBE
bvc	MBAELELEA
bvd	MBAENGGUU
bvh	BURE
bvi	BELANDA_VIRI
bvj	BAN_OGOI
bvk	BUKAT
bvo	BOLGO
bvp	BUMANG
bvq	BIRRI_C_AFRICAN_REP
bvr	BURARRA
bvw	BOGA
bvz	BAUZI
bwc	BWILE
bwd	BWAIDOKA
bwe	BWE_KAREN
bwi	BANIWA
bwj	LAA_LAA_BWAMU
bwk	BAUWAKI
bwl	BWELA
bwm	BIWAT
bwo	SHINASSHA
bwp	MANDOBO_BAWAH
bwq	SOUTHERN_BOBO_MADARE
bwr	BURA
bws	BOMBOMA
bwt	BAFAW_BALONG
bwu	BULI_GHANA
bwz	BWISI
bxb	BELANDA_BOR
bxd	PELA
bxf	BILUR
bxg	BANGALA
bxh	BUHUTU
bxk	BUKUSU
bxl	BLE
bxm	BURIAT_MONGOLIA
bxq	BEELE
bxr	BURIAT_RUSSIA
bxv	BABILI
bxz	BINAHARI
bya	BATAK
byc	UBAGHARA
bye	POUYE
byg	BAYGO
byh	BUJHYAL
byk	SHIDONG_BIAO
byl	BAYONO
bym	BIDJARA
byn	BILIN
byq	BASAY
byr	BARUYA
bys	BURAK
byt	BERTI
byv	MEDUMBA
byw	BELHARE
byx	QAQET
byz	BANARO
bza	BANDI
bzd	BRIBRI
bze	BOZO_JENAAMA
bzf	BOIKIN
bzg	FAVORLANG
bzh	BUANG_MAPOS
bzi	BISU
bzj	BELIZE_KRIOL_ENGLISH
bzk	NICARAGUA_CREOLE_ENGLISH
bzl	BOANO
bzm	BOLONDO
bzp	KEMBERANO
bzq	BULI
bzr	BIRI
bzu	BURMESO
bzw	RUBASA
caa	CHORTI
cab	GARIFUNA
cac	CHUJ
cad	CADDO
cae	LEHAR
caf	SOUTHERN_CARRIER
cag	NIVACLE
cah	CAHUARANO
cal	CAROLINIAN
cam	CEMUHI
can	CHAMBRI
cao	CHACOBO
cap	CHIPAYA
caq	CAR
car	KALINA
cas	MOSETEN
cat	CATALAN
caw	CALLAWALLA
cax	CHIQUITANO
cay	CAYUGA
caz	CANICHANA
cbb	CABIYARI
cbc	CARAPANA
cbd	CARIJONA
cbg	CHIMILA
cbi	CAYAPA
cbk	ZAMBOANGUENO
cbn	NYAKUR
cbo	IZORA
cbs	KAXINAWA
cbt	CHAYAHUITA
cbu	CANDOSHI
cbv	CACUA
ccc	CHAMICURO
ccg	SAMBA_DAGA
cch	ATSAM
ccj	KASANGA
cco	CHINANTEC_COMALTEPEC
ccp	CHAKMA_UnnamedInSource
ccr	CACAOPERA
cde	CHENCHU
cdf	CHIRU
cdh	CHAMBEALI
cdj	CHURAHI
cdm	CHEPANG
cdn	CHAUDANGSI
cdr	CINDA_REGI_TIYAL
cdy	CHADONG
cdz	KODA
cea	LOWER_CHEHALIS
ceb	CEBUANO
ceg	CHAMACOCO
cen	CEN
ces	CZECH
cfa	DIJIM_BWILIM
cfd	CARA
cga	CHANGRIWA
cgc	KAGAYANEN
cgg	CHIGA
cha	CHAMORRO
chb	CHIBCHA
chc	CATAWBA
chd	HIGHLAND_TEQUISTLATEC
che	CHECHEN
chf	CHONTAL_TABASCO
chg	CHAGATAI
chh	LOWER_CHINOOK
chj	CHINANTEC_OJITLAN
chk	TRUKESE
chl	CAHUILLA
chn	CHINOOK_WAWA
cho	CHOCTAW
chp	CHIPEWYAN
chq	CHINANTEC_QUIOTEPEC
chr	CHEROKEE
cht	CHOLON
chu	OLD_CHURCH_SLAVONIC
chv	CHUVASH
chw	CHUWABU
chx	CHANTYAL
chy	CHEYENNE
cic	CHICKASAW
cid	CHIMARIKO
cie	CINENI
cim	CIMBRIAN
cin	CINTA_LARGA
cip	CHIAPANEC
cir	GRAND_COULI
ciw	CHIPPEWA
ciy	CHAIMA
cja	CHAM_WESTERN
cje	CHRU
cjh	CHEHALIS_UPPER
cji	CHAMALAL
cjk	CHOKWE
cjm	CHAM_EASTERN
cjn	CHENAPIAN
cjo	ASHENINKA_PAJONAL
cjp	CABECAR
cjs	SHOR
cjv	CHUAVE
ckb	KURDISH_CENTRAL
ckh	CHAK
ckl	CIBAK
cko	ANUFO
ckq	KAJAKSE
ckt	CHUKCHEE
cku	KOASATI
ckv	KAVALAN
cky	MUSHERE
cla	RON
clc	CHILCOTIN
cld	ARAMAIC
cle	LEALAO_CHINANTEC
clh	CHILISSO
cli	CHAKALI
clk	IDU_MISHMI
cll	CHALA
clm	CLALLAM
clo	OAXACA_CHONTAL
clw	MIDDLE_CHULYM
cme	KIRMA
cmi	EMBERA_CHAMI
cml	CAMPALAGIAN
cnh	CHIN_HAKA
cni	ASHANINKA
cns	ASMAT_CENTRAL
cnt	CHINANTEC_TEPETOTUTLA
cnu	CHENOUA
cob	CHICOMUCELTEC
coc	COCOPA
cod	KOKAMA
coe	KOREGUAJE
cof	COLORADO
coh	CHONYI
coj	COCHIMI
col	COLUMBIA_WENATCHI
com	COMANCHE
con	COFAN
coo	COMOX
cop	COPTIC
cor	CORNISH
cos	CORSICAN
cot	CAQUINTE
cou	WAMEY
cov	SANJIANG_KAM
cow	COWLITZ
cox	NANTI
coz	CHOCHOTEC
cpa	CHINANTEC_PALANTLA
cpb	ASHENINKA_UCAYALI_YURUA
cpc	AJYININKA_APURUCAYALI
cpg	ROMEYKA
cps	CAPIZNON
cpu	ASHENINKA_PICHIS
cpx	PUTIAN_CHINESE
cra	CHARA
crb	ISLAND_CARIB
crc	LONWOLWOL
crd	COEUR_DALENE
crf	CARAMANTA
crg	MICHIF
crh	CRIMEAN_TATAR
cri	SANTOMENSE
crj	SOUTHERN_EAST_CREE
crk	PLAINS_CREE
crl	NORTHERN_EAST_CREE
crm	MOOSE_CREE
crn	EL_NAYAR_CORA
cro	CROW
crq	CHOROTE_IYOWUJWA
crs	SEYCHELLES_CREOLE
crt	CHOROTE
crw	CHRAU
crx	CARRIER
cry	CORI
crz	CRUZENYO
csb	KASHUBIAN
csm	CENTRAL_SIERRA_MIWOK
cso	CHINANTEC_SOCHIAPAN
cst	RAFAELENYO
csw	SWAMPY_CREE
csy	CHIN_SIYIN
csz	HANIS_COOS
cta	CHATINO_TATALTEPEC
ctd	CHIN_TEDIM
ctm	CHITIMACHA
ctn	CHHINTANGE
cto	CATIO
ctp	CHATINO_WESTERN_HIGHLAND
cts	NORTHERN_CATANDUANES
ctz	ZACATEPEC_CHATINO
cua	CUA
cub	CUBEO
cuc	CHINANTEC_SAN_FELIPE_USILA
cuh	CHUKA
cui	CUIBA
cuj	MASHCO_PIRO
cuk	KUNA_YALA_SAN_BLAS
cup	CUPENO
cuq	CUN
cut	SAN_ANDRES_TEOTILALPAM_CUICATEC
cuu	YUANYANG_TAI
cuv	CUVOK
cux	CUICATEC
cuy	CUITLATEC
cvg	CHUG
cwd	CREE_WOODS
cwe	NGHWELE
cwg	CEQ_WONG
cwt	KUWAATAAY
cyb	CAYUBABA
cym	WELSH
cyo	CUYONON
czo	YONGAN_CHINESE
daa	DANGALEAT
dac	DAMBI
dad	DAMI
dag	DAGBANI
dah	GWAHATIKE
dai	DAY
daj	NYALA
dak	DAKOTA
dal	DAHALO
dam	DAMAKAWA
dan	DANISH
daq	SOUTH_BASTAR_GONDI
dar	DARGWA
dau	SILA
dav	TAITA
dax	DALWONGO
dbb	DENAWA
dbd	DADIYA
dbe	DABE
dbf	EDOPI
dbg	DOGON_DOGUL_DOM
dbj	IDAAN
dbl	DYIRBAL
dbm	DUGURI
dbn	DURIANKERE
dbp	BODE_DOEI
dbq	DABA
dbr	DABARRE
dbt	BEN_TEY_DOGON
dbu	DOGON_BONDUM_DOM
dby	DIBIYASO
dcc	DECCAN
dcr	NEGERHOLLANDS
ddd	DONGOTONO
ddg	FATALUKU
ddi	DIODIO
ddj	JARU
ddn	DENDI
dds	DOGON_DONNO_SO
ddw	DAWERA_DAWELOOR
dec	DAGIK
ded	DEDUA
dee	DEWOIN
def	DEZFULI
deg	DEGEMA
dei	DEMISA
dep	PIDGIN_DELAWARE
deq	DENDI_CENTRAL_AFRICAN_REPUBLIC
der	DEURI
des	DESANO
deu	STANDARD_GERMAN
dev	DOMUNG
dga	DAGAARE
dgb	BUNOGE
dgd	DAGAARI_DIOULA
dge	DEGENAN
dgh	DGHWEDE
dgi	NORTHERN_DAGARA
dgk	DAGBA
dgo	DOGRI
dgr	DOGRIB
dgx	DOGHORO
dgz	DAGA
dhd	DHUNDARI
dhg	YOLNGUMATHA
dhi	DHIMAL
dhr	DHARGARI
dhs	DHAISO
dhu	DHURGA
dhv	DEHU
dhw	DANUWAR
dib	DINKA_SOUTH_CENTRAL
dic	DIDA_LAKOTA
did	DIDINGA
dif	DIYARI
dig	DIGO
dii	DIMBONG
dij	DAI
dik	REK
dil	DILLING
dim	DIME
dio	DIBO
dip	DINKA_NORTHEASTERN
diq	ZAZAKI
dir	DIRIM
dis	DIMASA
diu	DIRIKU
div	MALDIVIAN
diw	DINKA_NORTHWESTERN
diy	DIUWE
diz	DING
dja	DJADJALA
djb	DJINBA
djc	DADJO_EREF
djd	DJAMINDJUNG
dje	ZARMA
dji	DJINANG
djj	DJEEBBANA
djk	AUKAN
djm	DOGON_JAMSAY
djn	DJAUAN
djr	DJAMBARRPUYNGU
dju	KAPRIMAN
dka	DAKPAKHA
dks	DINKA_SOUTHEASTERN
dkx	DABA_DKX
dlg	DOLGAN
dlk	DAHALIK
dlm	DALMATIAN
dma	DUMA
dmc	DIMIR
dmd	MADHI_MADHI
dme	DUGWOR
dmk	DOMAAKI
dml	DAMELI
dmm	DAMA
dmo	KEMEZUNG
dmr	EAST_DAMAR
dms	DAMPELAS
dmu	DUBU
dmy	DEMTA
dna	DANI_UPPER_GRAND_VALLEY
dnd	DAONDA
dne	NDENDEULE
dng	DUNGAN
dnj	YAKOUBA
dnn	DZUUNGOO
dnr	DANARU
dnt	MID_GRAND_VALLEY_DANI
dnu	DANAU
dnw	LANI
dny	DENI
doa	DOM
dob	DOBU
doe	DOE
dof	DOMU
doh	DONG
dok	DONDO
dol	DOSO
don	DOURA
doo	DONGO
dop	LUKPA
dor	DORIO
dos	DOGOSE
dow	DOOHWAAYAAYO
dox	BUSSA
doy	DOMPO
doz	DORZE
drb	DAIR
drd	DARMIYA
dri	LELA
drl	DARLING
drn	WEST_DAMAR
dro	DARO_MATU
drs	GEDEO
dru	RUKAI
dry	DARAI
dsb	LOWER_SORBIAN
dsh	DAASANACH
dsi	DISA
dsn	DUSNER
dsq	TADAKSAHAK
dta	DAUR
dtd	DITIDAHT
dti	ANA_TINGA
dtk	DOGON_TENE_KAN
dtm	DOGON_TOMO_KAN
dtu	TEBUL_URE
dua	DUALA
duc	DUNA
due	UMIRAY_DUMAGET_AGTA
duf	DUMBEA
dug	DURUMA
duh	DUNGRA_BHIL
duk	UYAJITAYA
dun	DUSUN_DEYAH
duo	DUPANINGAN_AGTA
duq	DUSUN_MALANG
dur	YAG_DII
dus	DUMI
duu	DRUNG
duv	DUVLE
duw	DUSUN_WITU
dux	DUUNGOMA
duz	DULI
dwa	DIRI
dwr	KULLO
dwu	DHUWAL
dww	DAWAWA
dya	DYAN
dyi	DYIMINI
dyn	DYANGADI
dyy	DYAABUGAY
dzg	DAZAGA
dzo	DZONGKHA
ebg	EBUGHU
ebk	FINALLIG
ebr	EBRIE
ebu	EMBU
efa	EFAI
efe	EFE
efi	EFIK
ega	EGA
ego	EGGON
ehu	EHUEUN
eip	EIPOMEK
eit	EITIEP
eja	EJAMAT
eka	EKAJUK
eke	EKIT
ekg	KAPAUKU
ekk	ESTONIAN
ekm	LIBIE
eko	KOTI
ekp	EKPEYE
eky	KAYAH_LI_EASTERN
ele	ELEPI
elh	EL_HUGEIRAT
eli	NDING
elk	ELKEI
ell	MODERN_GREEK
elm	ELEME
elo	EL_MOLO
elx	ELAMITE
emb	EMBALOH
eme	EMERILLON
emi	MUSSAU_EMIRA
emk	MANINKAKAN_EASTERN
emp	EMBERA_NORTHERN
emw	EMPLAWAS
ena	EMERUM
enb	ENDO
end	ENDE
enf	FOREST_ENETS
eng	ENGLISH
enl	SANAPANA_ENLHET
enn	ENGENNI
eno	ENGGANO
enq	ENGA
enr	EMUMU
enu	ENU
enw	ENWANG
enx	LENGUA
eot	EOTILE_BETI
epi	EPIE
epo	ESPERANTO
erg	SIE
erh	ERUWA
eri	ERIMA
ero	GESHITSA
err	ERRE
ers	ERSU
ert	ERITAI
erw	KAMBRAM
ese	ESE_EJJA
esi	INUPIAQ
esk	NORTHWEST_ALASKA_INUPIATUN
esq	ESSELEN
ess	CENTRAL_SIBERIAN_YUPIK
esu	C_YUPIK
esy	ESKAYAN
etb	ETEBI
etn	ETON_VANUATU
eto	ETON_CAMEROON
etr	EDOLO
ets	YEKHEE
ett	ETRUSCAN
etu	EJAGHAM
etx	ITEN
eus	BASQUE
eve	EVEN
evh	UVBIE
evn	EVENKI
ewe	EWE
ewo	EWONDO
eya	EYAK
eyo	KEIYO
eze	UZEKWE
faa	FASU
fab	FA_D_AMBU
fad	KAMBA
faf	FAGANI
fai	ANGIYAKMIN_FAIWOL
faj	FAITA
fak	FANG
fam	FAM
fan	FANG
fao	FAROESE
fap	PALOR
far	FATALEKA
fau	FAYU
fax	FALA
fay	SOUTHWESTERN_FARS
fbl	OAS
fer	FEROGE
ffm	FULFULDE_MAASINA
fgr	FONGORO
fia	NOBIIN
fie	FYER
fij	FIJIAN
fin	FINNISH
fip	FIPA
fir	FIRAN
fkk	KIRYA_KONZEL
fla	KALISPEL_PEND_DOREILLE
flh	FOAU
fli	FALI
fll	NORTH_FALI
flr	FULIRU
fnb	ORKON
fng	FANAGALO
for	FORE
fos	SIRAYA
fpe	PICHI
fqs	FAS
fra	FRENCH
frd	FORDATA
frp	ARPITAN
frq	FORAK
frr	NORTH_FRISIAN_AMRUM
frs	EASTERN_FRISIAN
frt	FORTSENAL
fry	FRISIAN_WESTERN
fub	FULFULDE_ADAMAWA
fud	EAST_FUTUNA
fue	BORGU_FULFULDE
fuf	PULAR
fui	BAGIRMI_FULFULDE
fun	FULNIO
fuq	CENTRAL_EASTERN_NIGER_FULFULDE
fur	FRIULIAN
fuu	FURU
fuy	FUYUG
fvr	FUR
fwe	FWE
gaa	GA
gab	GABRI
gac	GREAT_ANDAMANESE
gae	WAREKENA
gaf	GENDE
gag	GAGAUZ
gah	ALEKANO
gai	GAMEI
gaj	GADSUP
gam	KANDAWO
gao	GANTS
gap	GAL
gaq	GATA
gas	ADIWASI_GARASIA
gau	MADHILI_GADABA
gaw	GARUH
gax	BORANA_OROMO
gay	GAYO
gbb	KAYTETYE
gbd	KARADJERI
gbf	GAIKUNDI
gbg	GBANZIRI
gbi	GALELA
gbj	BODO_GADABA
gbn	MODA
gbp	GBAYA_BOSSANGOA
gbq	GBAYA_BOZOUM
gbr	GBAGYI
gbu	GAAGUDJU
gbv	GBANU
gby	GBARI
gcc	MALI
gcd	GANGGALIDA
gce	GALICE
gcf	GUADELOUPE_CREOLE
gcl	GRENADIAN_CREOLE_ENGLISH
gcn	GAINA
gcr	GUIANESE_CREOLE_FRENCH
gdb	OLLARI_GADBA
gdc	GUGU_BUJUN
gdd	GEDAGED
gde	GUDE
gdf	GAVA
gdg	GADDANG
gdi	GUNDI
gdl	GIDOLE
gdm	LAAL
gdo	GODOBERI
gdq	MEHRI
gdu	GUDU
gea	GERUMA
geb	KIRE
ged	GADE
geg	GENGLE
geh	HUTTERITE_GERMAN
gei	GEBE
gej	GEN
gek	YIWOM
geq	GEME
gev	VIYA
gew	GERA
gex	GARRE
gey	ENYA
gez	GEEZ
gfk	PATPATAR
gft	GAFAT
gge	GURAGONE
ggk	KUNKARAKANY
ggl	GANGLAU
ggt	GITUA
ggu	GAGU
ggw	GOGODALA
gha	GHADAMES
ghl	UNCUNWEE
gho	GHOMARA
ghs	GUHU_SAMANE
gia	KITJA
gib	GIBANAWA
gid	GIDAR
gih	GIDABAL
gil	KIRIBATI
gim	GIMI
gin	HINUKH
giq	GREEN_GELAO
gis	NORTHERN_GIZIGA
git	GITXSAN
giu	MULAO
gix	NGBAKA_GILIMA
giz	MUTURUA
gjm	WARRNAMBOOL
gjn	GONJA
gkd	MAGI
gke	GALKE
gkn	GOKANA
gkp	KPELLE_GUINEA
gku	VAAL_ORANGE
gla	GAELIC_SCOTTISH
glc	BON_GULA
gld	NANAI
gle	IRISH
glg	GALICIAN
glj	GULA_IRO
glk	GILAKI
glo	GALAMBU
glu	GULA_CAR
glv	MANX
glw	GLAVDA
gly	GULE
gmb	KWAI
gmd	MAGHDI
gmm	GBAYA_MBODOMO
gmu	GUMALU
gmv	GAMO
gna	KAASA
gnd	ZULGO
gne	GANANG
gng	NGANGAM
gni	GOONIYANDI
gnk	GXANA
gnl	GANGULU
gnn	GOMAIDJ
gno	NORTHERN_GONDI
gnr	GURENG_GURENG
gnt	WARTA_THUNTAI
goa	GURO
gob	PLAYERO
goc	TOWANGARA
god	GODIE
goe	GONGDUK
gof	GOFA
gog	GOGO
goh	OLD_HIGH_GERMAN
gol	GOLA
gom	GOAN_KONKANI
gop	YERETUAR
gor	GORONTALO
gos	GRONINGS
got	GOTHIC
gou	GAVAR
gox	GOBU
goy	GOUNDO
gpa	GUPA_ABAWA
gpe	GHANAIAN_PIDGIN_ENGLISH
gpn	TAIAP
gqa	GAANDA
gqi	GUIQIONG
gqn	KINIKINAU
gqr	GOR
grc	GREEK_ANCIENT
grd	GURUNTUM_MBAARU
grg	MADI
grh	KAHUGU
gri	GHARI
grj	SOUTHERN_GREBO
grq	GOROVU
grr	TAZNATIT
grs	GRESI
grt	GARO
gru	SODDO
grx	GURIASO
gsl	JOOLA_GUSILAY
gsn	GUSAN
gsp	WASEMBO
gta	GUATO
gua	GUBAWA
gub	GUAJAJARA
guc	WAYUU
gud	DIDA_YOCOBOUE
gue	GURINDJI
gug	GUARANI
guh	GUAHIBO
gui	CHIRIGUANO
guj	GUJARATI
guk	GUMUZ
gum	GUAMBIANO
gun	MBYA
guo	GUAYABERO
guq	ACHE
gut	MELEKU_JAIKA
guu	YANOMAME
guw	GUNGBE
gux	GOURMANCHEMA
guz	GUSII
gva	KASHIKA
gvc	GUANANO
gve	DUWET
gvf	GOLIN
gvj	GUAJA
gvl	GULAY
gvm	GURMANA
gvn	KOKO_YALANDJI
gvo	GAVIAO_DO_RONDONIA
gvr	GURUNG
gvs	GUMAWANA
gwa	MBATO
gwc	KALAMI
gwd	GAWWADA
gwe	GWENO
gwg	MOO
gwi	KUTCHIN
gwj	GWI
gwr	GWERE
gwt	GAWAR_BATI
gwu	GUWAMU
gww	GUNIN_KWINI
gwx	HILL_GUANG
gxx	WE_SOUTHERN
gyb	GARUS
gyd	KAYARDILD
gye	GYEM
gyg	GBAYI
gyi	GYELE
gyl	GAYIL
gyn	GUYANESE_CREOLE_ENGLISH
gyr	GUARAYU
gyy	GUNYA
gza	GANZA
gzi	GAZI
gzn	GIMAN
haa	HAN
hac	GURANI
had	HATAM
hae	EASTERN_OROMO
hag	HANGA
ham	HEWA
han	HANGAZA
hao	HAKU
haq	HA
har	HARARI
has	HAISLA
hat	HAITIAN_CREOLE
hau	HAUSA
haw	HAWAIIAN
hax	HAIDA
hay	HAYA
hbb	HUBA
hbo	BIBLICAL_HEBREW
hbu	HABU
hca	ANDAMAN_CREOLE_HINDI
hch	HUICHOL
hdy	HADIYYA
heb	HEBREW
hed	HERDE
heg	HELONG
heh	HEHE
hei	HEILTSUK
her	HERERO
hgw	HAIGWAI
hhr	KERAK
hia	LAMANG_HITKALANCHI
hid	HIDATSA
hih	PAMOSU
hii	HINDURI
hil	HILIGAYNON
hin	HINDI
hio	MASARWA_TATI
hit	HITTITE
hiw	HIW
hix	HIXKARYANA
hka	KAHE
hke	HUNDE
hkk	HUNJARA_KAINA_KE
hla	HALIA
hlb	HALABI
hmb	TONDI_SONGWAY_KIINI
hmo	MOTU_HIRI
hmr	HMAR
hmt	HAMTAI
hmu	HAMAP
hna	MINA
hnh	ANI
hni	DAZHAI_HANI
hnj	HMONG_NJUA
hnn	HANUNOO
hoa	HOAVA
hob	MARI
hoc	HO
hod	HOLMA
hoe	HOROM
hoh	HOBYOT
hoi	HOLIKACHUK
hoj	HADOTI
hol	HOLU
hoo	HOLOHOLO
hop	HOPI
hor	HORO
hot	HOTE
hoz	HOZO
hpo	HPON
hra	HRANGKHOL
hrc	TANGA
hrk	HARUKU
hrt	HERTEVIN
hru	HRUSO
hrv	CROATIAN
hsb	UPPER_SORBIAN
hss	HARSUSI
hto	HUITOTO_MINICA
hts	HADZA
htu	HITU
hub	HUAMBISA
huc	HOAN_HUC
hue	SAN_FRANCISCO_DEL_MAR_HUAVE
hug	HUACHIPAERI
hul	HULA
hum	HUNGANA
hun	HUNGARIAN
hup	HUPA
huq	TSAT
hus	HUASTEC
hut	HUMLA
huu	HUITOTO_MURUI
huv	HUAVE
huw	HUKUMINA
hux	HUITOTO_NUPODE
huy	HULAULA
huz	HUNZIB
hvn	SAVU
hwc	HAWAI_CREOLE_ENGLISH
hwo	HWANA
hya	HYA
hye	ARMENIAN
hyw	WESTERN_ARMENIAN
iai	IAAI
ian	IATMUL
iar	PURARI
iba	IBAN
ibb	IBIBIO
ibd	IWAIDJA
ibe	AKUNNU
ibg	IBANAG
ibl	IBALOI
ibm	AGOI
ibn	IBINO
ibo	IGBO
ibr	IBUORO
iby	IBANI
ich	ETKYWAN
ida	IDAKHO_ISUKHA_TIRIKI
idi	DIBOLUG
idr	INDRI
idu	IDOMA
ifa	IFUGAO_AMGANAD
ifb	IFUGAO_BATAD
ife	IFE
igb	EBIRA
ige	IGEDE
igl	IGALA
igm	KANGGAPE
ign	IGNACIANO
igo	ISEBE
ihi	IHIEE
ihp	IHA
ijc	IZON
ije	BISENI
ijn	KALABARI
ike	INUKTITUT_EASTERN_CANADIAN
iki	IKO
ikk	IKA
ikl	KULU
iko	OLULUMO_IKOM
ikp	IKPESHI
ikt	KANGIRYUARMIUTUN
ikv	IKU_GORA_ANKWA
ikw	IKWERE
ikx	IK
ikz	IKIZU
ilb	ILA
ili	ILI_TURKI
ilk	ILONGOT_KAKIDUGEN
ilm	IRANUN
ilo	ILOKANO
ilv	ILUE
imn	IMONDA
imo	IMBONGU
imr	IMROING
inb	INGA
ind	INDONESIAN
inh	INGUSH
inj	INGA_MEDIO_PUTUMAYO
ino	YATE
inp	INAPARI
inz	INESENYO
ior	INNEMOR
iou	IRUMU
iow	IOWA_OTO
ipi	IPILI
ipo	IPIKO
iqu	IQUITO
ire	IRESIM
irh	IRARUTU
iri	KWOLL
irk	IRAQW
irn	IRANTXE
iru	IRULA
irx	KAMBERAU
isa	ISABI
isc	ISCONAHUA
isd	ISNAG
ish	ESAN
isl	ICELANDIC
isn	ISANZU
iso	ISOKO
ist	ISTRIOT
isu	ISU
ita	ITALIAN
itb	ITNEG_BINONGAN
itd	TIDONG
ite	MORE
itl	ITELMEN
itm	ITUMBUSO
ito	ITONAMA
itr	ITERI
its	ISEKIRI
itv	ITAWIT
itz	ITZAJ
ivb	BABUYAN
iwm	IWAM
iwo	MOROP
iws	SEPIK_IWAM
ixc	IXCATEC
ixl	IXIL_CHAJUL
iyx	IYAA
izh	INGRIAN
izr	IZERE
izz	IZI
jaa	JAMAMADI
jab	HYAM
jae	YABEM
jaf	JARA
jah	JAH_HUT
jaj	ZAZAO
jao	YANYUWA
jau	YAUR
jax	JAMBI_MALAY
jay	YANANGO
jaz	JAWE
jbi	BADJIRRI
jbk	BARIKEWA
jbn	NAFUSI
jbr	JOFOTEK
jbt	JABUTI
jbu	JUKUN_TAKUM
jda	JAD_INDIA
jdt	JUDEO_TAT
jeb	JEBERO
jee	JERUNG
jeh	JEH
jek	JERI_KUO
jel	YELMEK
jen	JENJO
jer	JERE
jet	MANEM
jgo	NGOMBA
jhi	JAHAI
jia	JINA
jib	JIBU
jic	JICAQUE
jid	BU_NIGERIA
jig	DJINGILI
jih	STODSDE
jii	JIDDU
jil	JILIM
jim	JIMI_CAMEROON
jio	JIAMAO
jit	JITA
jiu	JINO
jiv	SHUAR
jjr	BANKALA
jka	KAERA
jko	KUBO
jkr	KORO_INDIA
jku	LABIR
jle	NGILE
jma	DIMA
jmb	ZUMBUN
jmc	MACHAME
jmd	YAMDENA
jmi	JIMI
jmn	MAKURI_NAGA
jmr	KAMARA
jms	MASHI_NIGERIA
jmw	OMATI
jmx	SAN_MARTIN_PERAS_MIXTEC
jng	YANGMAN
jni	JANJI
jnj	JANJERO
jns	JAUNSARI
job	VIRA
jow	JOWULU
jpn	JAPANESE
jqr	JAQARU
jra	JARAI
jru	JAPRERIA
juc	JURCHEN
juh	HONE
juk	WAPAN
jul	JIREL
jum	JUMJUM
jun	JUANG
juo	JIBA
jup	JUPDA
jur	JURUNA
juu	SHO
juw	WAPHA
juy	JURAY
jya	JIARONG
jye	JUDEO_YEMENI_ARABIC
kaa	KARAKALPAK
kab	KABYLE
kac	JINGPHO
kad	KADARA
kae	KETANGALAN
kaf	KATSO
kah	KARA
kai	KAREKARE
kaj	JJU
kak	KALLAHAN_KAYAPA_PROPER
kal	KALAALLISUT
kam	KAMBA_KENYA
kan	KANNADA
kao	XAASONGAXANGO
kap	BEZHTA
kaq	CAPANAHUA
kas	KASHMIRI
kat	GEORGIAN
kav	KATUKINA
kaw	OLD_JAVANESE
kay	KAMAYURA
kaz	KAZAKH
kbb	KAXUYANA
kbc	KADIWEU
kbd	KABARDIAN
kbe	KANJU
kbh	KAMSA
kbi	KAPTIAU
kbj	KARI
kbk	KOIARI
kbl	KANEMBU
kbm	KAIWA
kbn	KALI
kbo	KELIKO
kbp	KABIYE
kbq	KAMANO
kbr	KEFA
kbs	KANDE
kbt	GABADI
kbu	KABUTRA
kbv	DERA
kbw	KAIEP
kbx	AP_MA
kby	MANGA_KANURI
kbz	DUHWA
kca	KHANTY
kcb	KAWACHA
kcc	LUBILA
kcd	KANUM_NGKALMPW
kcf	UKAAN
kcg	TYAP
kci	KAMANTON
kcj	KOBIANA
kck	KALANGA
kcl	KELA
kcn	KIBERA_KENYA
kco	KINALAKNA
kcp	KANGA
kcr	KATLA
kcs	KOENOEM
kct	KAIAN
kcu	KAMI
kcv	KETE
kcx	KACHAMA
kcy	KORANDJE
kda	WORIMI
kdc	KUTU
kdd	PITJANTJATJARA_YANKUNTJATJARA
kde	MAKONDE
kdh	TEM
kdi	KUMAN_UGANDA
kdj	KARIMOJONG
kdm	KAGOMA
kdn	KUNDA
kdp	NINKYOP
kdq	WANANG
kdr	KARAIM
kdt	KUY
kdu	KADARU
kdw	KONERAWSCH
kdx	KAM
kdy	KEDER
kea	CAPE_VERDEAN_CREOLE
keb	WESTERN_KELE_BUBI
kec	KEIGA
ked	KEREWE
keg	TESE
kei	KEI
kek	KEKCHI
kem	KEMAK
ken	KENYANG
keo	KAKWA
ker	KERA
ket	KET
keu	AKEBU
kew	KEWA
kez	KUKELE
kfa	KODAVA
kfb	NORTHWESTERN_KOLAMI
kfd	KORAGA_KORRA
kfe	KOTA_INDIA
kff	KOYA
kfk	KINNAURI
kfm	MEYMAI
kfn	KUK
kfo	KOROKAN
kfp	KORWA
kfq	KORKU
kfy	KUMAUNI
kfz	KOROMFE
kgb	KAWE
kge	KOMERING
kgf	HUBE
kgg	KUSUNDA
kgj	KHAM
kgk	GUARANI_KAIWA
kgl	KUNGGARI
kgn	KARINGANI
kgo	KRONGO
kgp	KAINGANG
kgq	KAMORO
kgr	ABUN
kgs	GUMBAYNGGIR
kgt	SOMYEV
kgu	KOGUMAN
kgv	KARAS
kgw	KARON_DORI
kgx	KAMARU
kgy	KYIRONG
kha	KHASI
khb	LU
khc	TUKANG_BESI_NORTHERN
khd	TOMER
khe	KOROWAI
khg	RGYALTHANG
khh	KEHU
khl	LUSI
khm	KHMER
khp	KAPAURI
khq	SONGHAY_KOYRA_CHIINI
khr	KHARIA
khs	KASUA
kht	KHAMTI
khu	NKHUMBI
khz	KEAPARA
kia	KIM
kib	RERE
kic	KICKAPOO
kid	KOSHIN
kie	KIBET
kih	KILMERI
kii	KITSAI
kij	KILIVILA
kik	GIKUYU
kil	KARIYA
kim	TOFA
kin	KINYARWANDA
kio	KIOWA
kiq	KOSARE
kir	KYRGYZ
kis	KIS
kiu	KIRMANJKI
kiv	KIMBU
kiy	KIRIKIRI
kja	MLAP
kjb	QANJOBAL_SANTA_EULALIA
kjc	COASTAL_KONJO
kjd	KIWAI_SOUTHERN
kje	KISAR
kjg	KHMU
kjh	KHAKAS
kji	ZABANA
kjj	KHINALUG
kjm	KHANG
kjn	KUNJEN
kjp	KAREN_PWO_EASTERN
kjq	ACOMA_KERES
kjr	KURUDU
kjs	KEWA_EAST
kju	KASHAYA
kjz	BUMTHANGKHA
kka	KAKANDA
kkb	KWERISA
kkc	ODOODEE
kke	KAKABE
kkh	TAI_KHUEN
kki	KAGULU
kkj	KAKO
kkk	KOKOTA
kkl	YALE_KOSAREK
kkm	KIONG
kko	KARKO
kkr	KIR_BALAR
kks	KIRFI
kkt	KOI
kky	GUUGU_YIMIDHIR
kkz	KASKA
kla	KLAMATH
klb	KILIWA
klc	KOLBILA
kld	GAMILARAAY
kle	KULUNG
kli	TARINDING
klj	KHALAJ_IRAN
kll	KALAGAN_KAAGAN
klm	KOLOM
klp	KAMASA
klq	RUMU
klr	KHALING
klt	NUKNA
klu	KLAO
klv	MASKELYNES
klx	KOLUWAWA
klz	KABOLA
kma	KONNI
kmb	MBUNDU
kmc	SOUTHERN_DONG
kme	BAKOLE
kmf	KARE
kmg	KATE
kmh	KALAM
kmi	KAMI_NIGERIA
kmj	KUMARBHAG_PAHARIA
kmk	LIMOS_KALINGA
kml	MINANGALI_LOWER_TANUDAN_KALINGA
kmm	KOM_INDIA
kmn	AWTUW
kmo	KWOMA
kmr	NORTHERN_KURDISH
kms	KAMASAU
kmt	KEMTUIK
kmu	KANITE
kmv	KARIPUNA_CREOLE
kmw	KOMO
kmx	WABUDA
kna	DERA
knb	KALINGA_GUINAANG
knc	KANURI
kne	KANKANAEY
knf	MANKANYA
kng	KOONGO
kni	ANIB
knj	ACATECO_SAN_MIGUEL_ACATAN
knk	KURANKO
knm	KANAMARI
knn	KONKANI
kno	KONO
knq	KINTAQ
knr	KANINGRA
kns	KENSIW
knv	TABO_WAIA
knw	KUNG_EKOKA
knx	SALAKO_BADAMEA
kny	KANYOK
koa	KONOMALA
kod	GAURA_NGGAURA
kof	KUBI
kog	KOGUI
koh	KOYO_EHAMBE_MAKUA
koi	KOMI_PERMYAK
kol	KOL_PNG
koo	KONZO
kop	KWATO
koq	KOTA
kor	KOREAN
kos	KUSAIE
kot	LAGWAN
kou	KOKE
kov	KUDU_CAMO
kow	KUGAMA
koy	KOYUKON
koz	KORAK
kpc	CURRIPACO
kpf	KOMBA
kpg	KAPINGAMARANGI
kpi	KOFEI
kpj	KARAJA
kpk	KPAN
kpl	NGBAKA_KPALA
kpo	IKPOSO
kpq	KORUPUN_SELA
kpr	KORAFE_YEGHA
kps	TEHIT
kpt	KARATA
kpu	KAFOA
kpv	KOMI_ZYRIAN
kpw	KOBON
kpx	MOUNTAIN_KOIALI
kpy	KORYAK
kpz	KUPSAPIINY
kqa	KATIATI
kqb	KOVAI
kqc	DOROMU_KOKI
kqd	KOY_SANJAQ_SURAT
kqe	KALAGAN
kqg	KHE
kqi	KOITABU
kqk	KOTAFON_GBE
kql	KYENELE
kqm	KHISA
kqn	KAONDE
kqo	EASTERN_KRAHN
kqq	KRENAK
kqr	KIMARAGANG
kqs	KISSI
kqw	KANDAS
kqx	MSER
kqy	KOORETE
kqz	KORANA
krb	KARKIN
krc	KARACHAY_BALKAR
kre	PANARA
krf	KORO
krh	KURAMA
kri	KRIO
krj	KINARAY_A
krl	KARELIAN
krp	KOROP
krr	BRAO_KRUNG
krs	GBAYA
kru	KURUKH
krx	KARON
kry	KRYZ
krz	SOTA
ksb	SHAMBALA
ksc	SOUTHERN_KALINGA
ksd	TOLAI
kse	KUNI
ksf	BAFIA
ksg	KUSAGHE
ksh	RIPUARIAN_GERMAN
ksi	ISAKA
ksj	UARE
ksk	KANSA
ksl	KUMARU
ksm	KUMBA
ksp	KABBA
ksq	KWAAMI
ksr	BORONG
kss	SOUTHERN_KISI
kst	KO_WINYE
ksu	KHAMYANG
ksv	KUSU
ksw	KAREN_SGAW
ksx	KEDANG
ksy	KHARIA_THAR
ktb	KAMBAATA
ktc	WIDALA
ktd	KOKATA
ktg	KALKUTUNG
kti	NINATIE_MUYU
ktk	KANIET
ktn	KARITIANA
kto	KUOT
ktp	KADUO
ktt	KETUM
ktv	KATU_EASTERN
ktw	KATO
ktx	KAXARARI
kua	KWANYAMA
kub	KUTEP
kuc	KWINSU
kue	KUMAN
kug	KUPA
kuh	KUSHI
kui	KUIKURO
kuj	KURIA
kul	KULERE
kum	KUMYK
kun	KUNAMA
kuo	KUMUKIO
kup	KUNIMAIPA
kus	KUSAL
kut	KUTENAI
kuu	UPPER_KUSKOKWIM
kuw	KPAGUA
kuy	KUUKU_YAU
kuz	KUNZA
kva	BAGWALAL
kvb	KUBU
kvc	KOVE
kvd	KUI_INDONESIA
kvf	KABALAY
kvg	KUNI_BOAZI
kvi	MODGEL
kvj	PSIKYE
kvm	KENDEM
kvn	CUNA
kvo	DOBEL
kvq	KAREN_GEBA
kvr	KERINCI
kvu	KAREN_YINBAW
kvw	WERSING
kvy	KAREN_YINTALE
kvz	TTSAKWAMBO
kwa	DAW
kwb	KWA_NIGERIA
kwc	LIKWALA
kwd	KWAIO
kwf	KWARAAE
kwg	KABA_DEME_SARA
kwh	KOWIAI
kwi	AWA_PIT
kwj	KWANGA
kwk	KWAKWALA
kwl	KOFYAR
kwm	KWAMBI
kwn	KWANGALI
kwo	KWOMTARI
kwr	KWER
kws	KWESE
kwt	KWESTEN
kwu	KWAKUM
kwv	NA_CHAD
kww	KWINTI
kwy	KONGO_SAN_SALVADOR
kwz	KWADI
kxa	KAIRIRU
kxb	KROBU
kxc	KOMSO
kxd	BRUNEI
kxf	KAREN_MANUMANAW
kxh	KARO
kxj	KULFA
kxm	SURIN
kxo	KANOE
kxq	RAWA_BIRU
kxs	KANGJIA
kxt	KOIWAT
kxv	KUVI
kxw	KONAI
kxz	KEREWO
kya	KWAYA
kyc	KYAKA_ENGA
kye	KRACHE
kyh	KAROK
kyi	KIPUT
kyl	SANTIAM
kyq	KENGA
kyr	KURUAYA
kyt	KAYAGAR
kyu	KAYAH_WESTERN
kyw	KUDMALI
kyx	RAPOISI
kyy	KAMBAIRA
kyz	KAYABI
kza	WESTERN_KARABORO
kzc	BUDUKU_KULANGO
kzf	DAA
kzg	KAMIKATETSU_KIKAI
kzi	BARIO_KELABIT
kzk	KAZUKURU
kzl	KAYELI
kzm	KAIS
kzo	KANINGI
kzp	KAIDIPANG
kzq	KAIKE
kzr	KARANG
kzu	KAYUPULAU
kzv	KOMYANDARET
kzw	KARIRI
lac	LACANDON
lad	JUDEO_ESPAGNOL
lae	PATTANI
laf	TEGEM
lag	RANGI
lai	LAMBYA
laj	LANGO
lam	LAMBA
lan	LARU_NIGERIA
lao	LAO
lap	LAKA
laq	PUBIAO
lar	LARTEH
las	LAMA
lat	LATIN
law	LAUJE
lax	TIWA
laz	ARIBWATSA
lbb	LABEL
lbe	LAK
lbf	TINANI
lbi	LABI
lbj	LADAKHI
lbl	LIBON
lbm	LODHI
lbn	LAMPANGLAMET
lbq	WAMPAR
lbr	LOHORUNG
lbt	LACHI
lbu	LABU
lbv	LAMASONG
lbw	TOLAKI
lbx	LAWANGAN
lcc	LANGANYAN
lcf	LUBU
lch	LUCAZI
lcl	LISELA
lcm	TUNGAK
lcp	LAWA_LA_UP
ldb	IDU
ldg	LENYIMA
ldj	LEMORO
ldk	LEELAU
ldl	KAAN
ldm	LANDOMA
ldo	LOO
ldq	LUFU
lea	LEGA_SHABUNDA
lec	LEKO
led	LENDU
lee	LYELE
lef	BUEM_LELEMI
leh	LENJE
lei	LEMIO
lej	LENGOLA
lek	LEIPON
lel	LWEL_KILORI
lem	NOMAANDE
lep	LEPCHA
leq	LEMBENA
les	BALESE
leu	KARA
lev	LAMMA
lex	LUANG
ley	LEMOLANG
lfa	LEFA
lga	LUNGGA
lgg	LUGBARA
lgk	LINGARAK
lgl	WALA
lgm	LEGA_MWENGA
lgn	LANGA
lgq	LOGBA
lgr	LENGO
lgt	PAHI
lgu	LONGGU
lha	LAHA
lhm	LHOMI
lhn	LAHANAN
lhs	MLAHSO
lht	TOGA
lhu	LAHU
lia	WEST_CENTRAL_LIMBA
lib	LIKUM
lid	NYINDROU
lif	LIMBU
lig	LIGBI
lih	SUNGLIK_LIHIR
lik	LILIKO
lil	LILLOOET
lim	LIMBURGISH
lin	LINGALA
lip	LIKPE
liq	LIBIDO
lis	LISU
lit	LITHUANIAN
liu	LOGORIK
lix	LIABUKA
liy	LINDA
liz	LIBINZA
lje	RAMPI
lji	LAIYOLO
ljl	LIO
lkj	REMUN
lkn	LAKONA
lkr	PARI
lkt	LAKOTA
lky	LOKOYA
lla	LALA_NIGERIA
llb	LOLO
llc	LELE_GUINEA
lle	LELE
llf	HERMIT
lli	WESTERN_TEKE_LAALI
llk	LELAK
lll	LILAU
llm	LASALIMU
lln	LELE_CHAD
llu	LAU
lma	EAST_LIMBA
lmb	LAMETIN
lmc	LIMILNGAN
lmd	LUMUN
lmg	LAMOGAI
lmi	LOMBI
lml	RAGA
lmn	LAMANI
lmp	LIMBUM
lmr	LAMALERA
lmu	LAMENU
lmw	MIWOK_LAKE
lmx	BU_CAMEROON
lmy	LAMBOYA
lna	LANGBASI
lnb	MBALANHU
lnd	LUN_BAWANG
lnh	LANOH
lnj	LENINGITIJ
lnm	LANGAM
lnn	LOREDIAKARKAR
lns	LAMNSOQ
lnu	LONGUDA
loa	LOLODA
lob	LOBI
lof	LOGOL
log	LOGO
loh	NARIM_LARIM
loj	LOU
lok	LOKO
lol	MONGO
lom	LOMA_LIBERIA
loo	LOMBO
lop	LOPA
loq	LOBALA
lor	LORHON
los	LONIU
loy	LOWA
loz	SILOZI
lpa	LELEPA
lpe	LEPKI
lpx	LOPIT
lra	LARA
lrg	LARRAKIA
lrl	LARESTANI
lro	LARU_SUDAN
lrr	SOUTHERN_YAMPHU
lrv	LAREVAT
lrz	LEMERIG
lsa	LASGERDI
lsd	LISHANA_DENI
lsh	LISH
lsi	LASHI
lsm	SAMIA
lsr	SRENGE
lss	LASI
ltc	MIDDLE_CHINESE
lti	LETINESE
lto	TSOTSO
ltz	LUXEMBOURGISH
lua	LUBA
lub	KILUBA
luc	ARINGA
lue	LUVALE
luf	LAUA
lug	GANDA
lui	LUISENO
lun	LUNDA
luo	LUO
lup	LUMBU
lus	LUSHAI
lut	LUSHOOTSEED
luz	LURI
lvi	LAWI
lvk	LAVUKALEVE
lvs	LATVIAN
lwg	WANGA
lwh	WHITE_LACHI
lwl	WIANG_PA_PAO_LUA
lwo	GIUR
lyg	LYNGNGAM
lzl	LITZLITZ
lzn	LEINONG
lzz	LAZ
maa	SAN_JERONIMO_TECOATL
mad	MADURESE
mae	RUKUL
maf	MAFA
mag	MAGAHI
mah	MARSHALLESE
mai	MAITHILI
maj	JALAPA_DE_DIAZ
mak	MAKASAR
mal	MALAYALAM
maq	MAZATEC_CHIQUIHUITLAN
mar	MARATHI
mas	MAASAI
mat	MATLATZINCA_SAN_FRANCISCO_OXTOTILPAN
mau	HUAUTLA_DE_JIMENEZ
mav	SATERE_MAWE
maw	MAMPRULI
max	TERNATE_PASAR
maz	MAZAHUA_CENTRAL
mba	HIGAONON_BINUKID
mbb	MANOBO_WESTERN_BUKIDNON
mbc	MACUSHI
mbd	MANOBO_DIBABAWON
mbe	MOLALA
mbf	MALAY_BABA
mbi	MANOBO_ILIANEN
mbj	NADEB
mbk	MALOL
mbl	MAXAKALI
mbm	OMBAMBA
mbn	MACAGUAN
mbo	MBO
mbp	DAMANA
mbq	MAISIN
mbr	NUKAK_MAKU
mbs	MANOBO_SARANGANI
mbt	MANOBO_TIGWA
mbv	BAGA_FORE
mbw	MARING
mbx	MARI_PNG
mca	MACA
mcb	MACHIGUENGA
mcc	BITURI
mcd	SHARANAHUA
mcf	MATSES
mcg	MAPOYO
mch	MAQUIRITARI
mci	MOMOLILI
mcj	KAMKAM
mck	MBUNDA
mcm	PAPIA_KRISTANG
mcn	MASANA
mcp	MAKAA
mcq	ESE_MANAGALASI
mcr	MENYA
mcs	MAMBAI
mct	MENGISA
mcu	MAMBILA_ATTA
mcv	MINANIBAI
mcw	MAWA_CHAD
mcx	MPIEMO
mcz	MAWAN
mda	MADA
mdb	MORIGI
mdc	MALE_PAPUANG
mdd	MBUM
mde	MABA_CHAD
mdf	MOKSHA
mdi	MAMVU
mdj	MANGBETU
mdk	MANGBUTU
mdm	MAYOGO
mdn	ISONGO
mdp	MBALA
mdr	MANDAR
mds	OISO
mdt	MBERE
mdw	MBOSI
mdy	MALE_ETHIOPIA
mdz	SURUI_DO_PARA
meb	MENA
mec	MARA
med	MELPA
mee	MENGEN
mei	MEIDOB_NUBIAN
mej	MEYAH
mek	MEKEO
mel	MUKAH_MELANAU
men	MENDE
mep	MIRIWUNG
meq	MEREY
mer	MERU
mes	MASMEDJE
met	MATO
meu	MOTU
mew	MAAKA
mey	HASSANIYA
mez	MENOMINEE
mfa	MALAY_PATTANI
mfb	LOM
mfc	MBA
mfd	MENDANKWE_NKWEN
mfe	MAURITIAN
mff	NAKI
mfg	MIXIFORE
mfh	MATAL
mfi	WANDALA
mfj	MEFELE
mfk	NORTH_MOFU
mfl	PUTAI
mfn	CROSS_RIVER_MBEMBE
mfo	MBE
mfq	MOBA
mfr	MARITHIEL
mft	MOKERANG
mfw	MULAHA
mfx	MELO
mfy	MAYO
mfz	MABAAN
mgb	MARARIT
mgc	MOROKODO
mgd	MORU
mge	MANGO
mgi	JILI
mgk	MAWES
mgl	MALEU
mgm	MAMBAE
mgp	MAGAR
mgq	MALILA
mgr	MAMBWE_LUNGU
mgt	MONGOL
mgu	MAILU
mgv	MATENGO
mgy	MBUNGA
mgz	MBUGWE
mha	MANDA_INDIA
mhb	MAHONGWE
mhc	MOCHO
mhe	MAH_MERI
mhf	MAMAA
mhg	MARGU
mhi	MADI
mhj	MOGHOL
mhk	MUNGAKA
mhl	ULINGAN
mho	MASHI_ZAMBIA
mhq	MANDAN
mhs	BURU_MASARETE
mht	MANDAHUACA
mhu	TARAON
mhw	MBUKUSHU
mhx	MARU
mhy	SAMIHIM
mhz	MOR
mia	MIAMI
mib	ATATLAHUCA_MIXTEC
mic	MICMAC
mie	OCOTEPEC_MIXTEC
mif	MOFU_GUDUR
mig	CHALCATONGO_MIXTEC
mih	MIXTEC_CHAYUCO
mij	ABAR
mik	MIKASUKI
mil	MIXTEC_PENYOLES
min	MINANGKABAU
mio	JICALTEPEC_MIXTEC
miq	MISKITO
mir	GUICHICOVI_MIXE
miw	AKOYE
mjc	MIXTECO_DE_SAN_JUAN_COLORADO
mje	MUSKUM
mjg	MONGUOR
mjj	MAWAK
mjk	MATUKAR
mjl	MANDEALI
mjm	MEDEBUR
mjs	MISHIP
mjt	SAURIA_PAHARIA
mjw	KARBI
mjy	MAHICAN
mka	MBRE
mkb	MAL_PAHARIA
mkc	SELEPUT
mkd	MACEDONIAN
mke	MAWCHI
mkf	MIYA
mkg	MAK
mkj	MOKILESE
mkm	MOKLEN
mkn	KUPANG_MALAY
mko	MUNGA_DOSO
mkp	MOIKODI
mkr	MALAS
mks	SILACAYOAPAN_MIXTEC
mku	KONYANKA_MANINKA
mkv	MAFEA
mkw	KITUBA
mky	EAST_MAKIAN
mkz	MAKASAE
mlb	MBULE
mle	MANAMBU
mlf	MAL
mlh	MAPE
mlk	ILWANA
mll	MALUA_BAY
mln	MALANGO
mlo	JOOLA_MLOMP
mlp	MUGIL
mlr	VAME
mls	MASALIT
mlt	MALTESE
mlu	TOABAITA
mlv	MOTLAV
mlw	MOLOKO
mlx	MALFAXAL
mma	MAMA
mmd	MAONAN
mme	MAE
mmf	MUNDAT
mmh	MEHINAKU
mmi	MUSAR
mml	KEMIE
mmm	MAII
mmn	MAMANWA
mmo	MANGA
mmp	SIAWI
mmq	MUSAK
mmw	EMAE
mmx	MADAK
mmy	MIGAMA
mmz	MABAALE
mnb	MUNA
mnc	MANCHU
mnd	MONDE
mne	NABA_KUKA
mnf	MUNDANI
mnh	MONO_CONGO
mni	MEITEI
mnj	MUNJANI
mnk	MANDINKA
mnl	MALMARIV
mnp	MINNORTH_JIANOU
mnr	WESTERN_MONO
mns	MANSI
mnu	MER
mnv	RENNELLESE
mnw	MON
mnx	SOUGB
moa	MWAN
moc	MOCOVI
mod	MOBILIAN_JARGON
moe	MONTAGNAIS
mog	MONGONDOW
moh	MOHAWK
moi	MBOI
moj	MONZOMBO
mok	MORORI
mom	MANGUE
moq	MOR_PAPUAN
mor	MORO
mos	MOORE
mou	MOGUM
mov	MOHAVE
mox	MOLIMA
moy	MOCHA
moz	MOKILKO
mpa	MPOTO
mpb	MULLUKMULLUK
mpc	MANGARAYI
mpd	MAXINERI
mpe	MESENGO
mpg	MARBA
mph	MAWNG
mpi	MAKARY_KOTOKO
mpj	MARTU_WANGKA
mpk	MBARA
mpm	YOSONDUA_MIXTEC
mpp	MIGABAC
mpq	MATIS
mpr	MBAREKE
mps	DARIBI
mpt	MIAN
mpu	MAKURAP
mpv	MUNGKIP
mpw	MAPIDIAN
mpx	MISIMA_PANAEATI
mpz	MPI
mqb	MBUKO
mqe	MATEPI
mqf	MOMUNA
mql	MBELIME
mqn	MORONENE
mqo	MODOLE
mqs	WEST_MAKIAN
mqt	MOK
mqu	MONDARI
mqv	MOSIMO
mqw	MURUPI
mqx	MAMUJU
mqy	MANGGARAI
mqz	MALASANGA
mra	MLABRI
mrb	MARINO
mrc	MARICOPA
mrd	WESTERN_MAGAR
mrf	ELSENG
mrg	MISING
mrh	LAKHER_MARA
mri	MAORI
mrk	FA_TIETA
mrl	MORTLOCKESE
mrm	MERLAV
mrn	CHEKE_HOLO
mro	MRU
mrp	MOROUAS
mrq	NORTH_MARQUESAN
mrs	MARAGUS
mrt	MARGI
mrw	MARANAO
mrx	DINEOR
mrz	MARIND
msb	MASBATENYO
msc	SANKARAN_MANINKA
mse	MUSEY
msh	MALAGASY_MASIKORO_MIARY
msj	MA
msk	MANSAKA
msl	MOLOF
mso	MOMBUM
msq	CAAC
msu	MUSOM
msw	MANSOANKA
msx	MORESADA
msy	ARUAMU
msz	MOMARE
mta	MANOBO_KALAMANSIG_COTABATO
mtc	MUNIT
mtd	MUALANG
mte	MONO
mtf	MURIK
mtg	UNA
mth	MUNGGUI
mti	MAIWA
mtj	MOSKONA
mtl	MONTOL
mto	NORTH_HIGHLAND_MIXE
mtq	MUNG_KOI
mtt	MOTA
mtv	ASARO7O
mty	NABI
mua	MUNDANG
mub	MUBI
muc	MBU
mud	MEDNYJ_ALEUT
muh	MUNDU
muj	MABIRE
muk	MUGOM
muo	NYONG
mup	MALVI
mur	MURLE
mus	CREEK
mut	WESTERN_MURIA
muu	MOGOGODO
muv	MUTHUVAN
mux	KU_WARU
muy	MUYANG
muz	MURSI
mva	MANAM
mvb	MATTOLE
mvd	MAMBORU
mvf	KALAQIN
mvi	MIYAKO
mvk	MEKMEK
mvn	MINAVEHA
mvo	MAROVO
mvq	MOERE
mvs	MASSEP
mvt	MPOTOVORO_VOVO
mvx	MEOSWAR
mvy	INDUS_KOHISTANI
mvz	MESQAN
mwb	MUNIWARA
mwc	ARE
mwe	MWERA
mwg	AIKLEP
mwi	LABO
mwk	MANINKAKAN_KITA
mwl	MIRANDESE
mwm	SAR_CHAD
mwn	NYAMWANGA
mwo	CENTRAL_MAEWO
mwp	KALA_LAGGAW_YA
mws	MWIMBI_MUTHAMBI
mwt	MOKEN
mwu	MITTU
mwv	MENTAWAI
mww	HMONG_DAW
mxc	SHONA_MANYIKA
mxd	MODANG
mxf	MALGBE
mxg	MBANGALA
mxh	MVUBA
mxj	KAMAN
mxk	MONUMBO
mxl	MAXI_GBE
mxn	MOI
mxq	JUQUILA_MIXE
mxu	MADA_CAMEROON
mxw	NAMO
mxz	CENTRAL_MASELA
mya	BURMESE
myb	MBAY
mye	MYENE
myf	BAMBASSI
myg	AMASI
myh	MAKAH
myj	MANGAYAT
myk	MAMARA_SENOUFO
myl	MOMA
mym	MEEN
myo	ANFILLO
myp	PIRAHA
myr	MUNICHI
mys	MESMES
myu	MUNDURUKU
myv	ERZYA
myw	MUYUW
myy	MACUNA
myz	CLASSICAL_MANDAIC
mzb	TUMZABT
mze	MORAWA
mzh	WICHI_LHAMTES_GUISNAY
mzi	SAN_PEDRO_IXCATLAN
mzk	MAMBILA
mzm	MUMUYE
mzn	MAZANDERANI
mzp	MOVIMA
mzq	MORI_ATAS
mzr	MARUBO
mzt	MINTIL
mzu	ITUTANG
mzv	MANZA
mzw	DEG
naa	NAMLA
nab	NAMBIKWARA
nac	NARAK
naf	NABAK
naj	NALU
nak	NAKANAI
nal	NALIK
nap	NEAPOLITAN_CALABRESE
nar	IGUTA
nas	NASIOI
nat	HUNGWORO
nau	NAURUAN
nav	NAVAJO
naw	NAWURI
nax	NAKWI
nay	YARALDI
nba	NGANGELA
nbc	NAGA_CHANG
nbd	NGBINDA
nbe	NAGA_KONYAK
nbh	NGAMO
nbi	NAGA_MAO
nbj	NGARINMAN_BILINARA
nbk	NAKE
nbl	NDEBELE
nbm	NGBAKA_MABO
nbn	KURI
nbo	NKUKOLI
nbp	NNAM
nbq	NGGEM
nbr	NUNKU
nbt	NA_INDIA
nbu	KABUI_RONGMEI
nbv	NGAMAMBO
nbw	NGBANDI
nby	NINGERA
nca	IYO
ncb	NANCAWRI
ncc	PONAM
ncd	NACHERING
ncg	NISGHA
nch	NAHUATL_CHICONTEPEC
nci	CLASSICAL_NAHUATL
nck	NAKARA
ncl	NAHUATL_POMARO_AQUILA
ncm	NAMBO
ncn	NAUNA
ncr	NCANE
nct	CHOTHE
ncu	CHUMBURUNG
ncx	NAHUATL_HUATLATLAUCA
ncz	NATCHEZ
nda	NORTHERN_NDASA
ndb	KENSWEI_NSEI
ndc	SHONA_NDAU
ndg	NDENGEREKO
ndh	NDALI
ndi	SAMBA_LEKO
ndj	NDAMBA
ndk	INDAAKA
ndl	NDOLO
ndm	NDAM
ndn	NGONDI
ndo	NDONGA
ndr	NDOLA
nds	NORTHERN_LOW_SAXON
ndt	NDUNGA
ndu	PAPE
ndv	NDUT
ndw	NDOOBO
ndx	DAO
ndy	NDOKA
ndz	NDOGO
neb	TOURA
nec	NEDEBANG
nee	NELEMWA
neg	NEGIDAL
nej	NEKO
nem	NEMI
nen	NENGONE
ner	YAHADIAN
nev	NHAHEUN
nex	NEME_MUM
ney	NEYO
nez	NEZ_PERCE
nfa	DHAO
nfl	AYIWO
nfr	NAFAARA
nfu	MFUMTE
nga	NGBAKA
ngb	NORTHERN_NGBANDI
ngc	NGOMBE
nge	MANKON
ngg	NGBAKA_MANZA
ngi	NGIZIM
ngk	BUAN
ngl	LOMWE
ngn	NGWO
ngp	NGULU
ngq	NGURIMI
ngr	NANGGU
ngs	GVOKO
ngt	NGE
ngv	NAGUMI
ngx	NGGWAHYI
ngy	TIBEA
ngz	NGUNGWEL
nha	NHANDA
nhb	BENG
nhc	TABASCO_NAHUATL_CUPILCO
nhe	NAHUATL_BUENOS_AIRES_ALAMO
nhg	TETELCINGO_NAHUATL
nhh	NAHARI
nhi	NAHUATL_CUACUILA_HUAUCHINANGO
nhm	NAHUATL_TEPOTZTLAN
nho	TAKUU_MORTLOCK
nhp	NAHUATL_PAJAPAN
nhq	NAHUATL_RAFAEL_DELGADO
nhr	NARO
nhu	NONI
nhw	NAHUATL_COXCATLAN
nhx	NAHUATL_MECAYAPAN
nhy	NAHUATL_SAN_BERNARDINO_TEOTITLAN_DEL_CAMINO
nib	NAKAME
nid	NGANDI
nie	LUA_NIELLIM
nif	NEK
nig	NGALAKAN
nih	NYIHA_TANZANIA
nii	NII
nil	NILA
nim	NILAMBA
nin	SAMBE
nio	NGANASAN
niq	NANDI
nis	NIMI
niu	NIUE
niv	GILYAK
niw	NIMO
niy	NGITI
niz	NINGIL
nja	NZANYI
njb	NAGA_NOCTE
njh	NAGA_LOTHA
nji	GUDANJI
njj	NJEN
njl	NYALGULGULE
njm	ANGAMI
njn	NAGA_LIANGMAI
njo	NAGA_AO
njr	NJEREP
njt	NDYUKA_TRIO_PIDGIN
nju	NGADJUNMAYA
njx	KUNYI
njy	NJYEM
nka	NKOYA
nkb	NAGA_KHOIBU
nkc	NKONGHO
nkd	KOIRENG
nke	DUKE
nkg	NEKGINI
nkh	KHEZHA
nki	NAGA_THANGAL
nkj	NAKAI
nkk	NOKUKU
nkm	NAMAT
nko	NKAMI
nkr	NUKUORO
nks	ASMATH_NORTH
nkt	NYIKA_TANZANIA
nku	KULANGO_BOUNA
nkv	NYIKA
nkw	KUCU_WELA_ANKUTCU
nkx	NKORO
nla	NGOMBALE
nlc	NALCA
nld	DUTCH
nlg	NGGELA
nli	GRANGALI
nlj	NYALI
nll	NIHALI
nlo	NGUL
nlu	NCHUMBULU
nlx	NAHALI
nma	NAGA_MARAM
nmc	NGAM
nmd	NDUMU
nme	NAGA_MZIEME
nmf	NAGA_TANGKHUL
nmg	KWASIO
nmi	NYAM
nml	NDEMLI
nmm	MANANGE
nmr	NIAM_NIAM
nms	LETEMBOI
nmu	NE_MAIDU
nmv	NGAMINI
nmw	NIMOA
nmy	NAMUZI
nmz	NAWDM
nna	NYANGUMARTA
nnb	NANDE
nnc	NANCERE
nnd	WEST_AMBAE
nnf	NGAING
nng	NAGA_MARING
nnh	NGIEMBOON
nnj	NYANGATOM
nnk	NANKINA
nnl	NAGA_RENGMA
nnm	NAMIA
nnp	NAGA_WANCHO
nnq	NGINDO
nnr	NARUNGGA
nnt	NANTICOKE
nnu	DWANG
nnv	NUGUNU_AUSTRALIA
nnw	SOUTHERN_NUNI
nnz	NDANDA_SUD
noa	WOUNAAN
noc	NUK
nof	NOMANE
nog	NOGAI
noh	NOMU
noj	NONUYA
nok	NOOKSACK
non	OLD_NORSE
nop	NUMANGGANG
noq	NGONGO
not	NOMATSIGUENGA
nou	EWAGE_NOTU
now	NYAMBO
noy	NOY
noz	NAYI
npa	NAR_PHU
nph	NAGA_PHOM
npi	NEPALI
npl	NAHUATL_SAN_JOSE_MIAHUATLAN
npo	NAGA_POCHURI
nqn	NEN
nrb	NARA
nre	NAGA_SOUTHERN_RENGMA
nrg	NARANGO
nri	NAGA_CHOKRI
nrk	NGARLA
nrl	NGALOOMA
nrm	NAROM
nrt	TUALATIN
nru	MOSUO
nrz	LALA
nsa	NAGA_SANGTAM
nsb	AUNI
nse	NSENGA
nsg	ONGAMO
nsh	NGOSHIE
nsk	NASKAPI
nsm	NAGA_SUMI
nsn	NEHAN
nsq	NORTHERN_SIERRA_MIWOK
nss	JIRIW
nsu	NAHUATL_SAN_PABLO_ZOQUITLAN
nsw	NAVUT
nsy	NASAL
nsz	NISENAN
nti	NATIORO
ntj	NGAANYATJARRA
ntk	IKOMA
ntm	NATENI
nto	NTOMBA
ntp	NORTHERN_TEPEHUAN
ntw	NOTTOWAY
ntz	NATANZI
nua	YUAGA
nud	NGALA
nue	NGUNDU
nuf	NUSU
nui	NGUMBI
nuj	NYOLE
nuk	NOOTKA
nul	NUSA_LAUT
num	NIUAFOOU
nun	ANONG
nup	NUPE_TAKO
nur	NUKURIA
nus	NUER
nut	NUNG
nuu	NGBUNDU
nuv	NORTHERN_NUNI
nuw	NGULUWAN
nux	MEHEK
nuy	NUNGGUBUYU
nvo	NYOKON
nwb	NYABWA
nwe	NGWE
nwm	NYAMUSA_MOLO
nwr	SIRIO
nxa	NAUETE
nxg	NGADHA
nxl	FATAKAI_NUAULU_SERAM
nxn	NGAWUN
nxq	NAXI
nxr	NINGGIRUM_KAWOMA
nxx	NAFRI
nya	NYANJA
nyb	TUTRUGBU
nyd	NYORE
nyf	GIRYAMA
nyh	NYIGINA
nyi	AMA_AFRICA
nyj	NYANGA
nyk	NYANEKA
nyl	NYEU
nym	NYAMWEZI
nyo	NYORO
nyp	NYANGI
nyq	NAYINI
nyr	NYIHA_MALAWI
nyt	NYAWAYGI
nyu	NYUNGWE
nyv	NYULNYUL
nyx	NGANYAYWANA
nyy	NYAKYUSA_NGONDE
nza	TIGON_MBEMBE
nzb	NJEBI
nzi	NZEMA
nzk	NZAKARA
nzm	NAGA_ZEME
oaa	OROK
oac	OROCH
obi	OBISPENYO
oca	OCAINA
och	OLD_CHINESE
ocu	OCUILTECO
ofo	OFO
ofs	OLD_FRISIAN
ofu	EFUTOP
ogc	OGBA
ogo	KANA
ogu	OGBRONUAGUM
oia	OIRATA
oin	ONE_INEBU
ojg	OJIBWA_EASTERN
ojs	OJIBWA_SEVERN
ojv	LUANGIUA
ojw	SAULTEAUX
oka	OKANAGAN_COLVILLE
okb	OKOBO
okd	AKITA
oke	OKPE
okh	KORESH_E_ROSTAM
oki	SOGOO
okj	OKO_JUWOI
okk	KWAMTIM_ONE
okr	OKRIKA
oks	OKO_OSANYE_ENI
oku	OKU
okv	OROKAIVA
old	MOCHI
olm	OLOMA
olo	OLONETS_KARELIAN
oma	OMAHA_PONCA
omc	MOCHICA
omg	OMAGUA
omi	OMI
oml	OMBO
omo	OSUM
omt	OMOTIK
omu	OMURANO
omw	TAIRORA_SOUTH
omx	OLD_MON
ona	ONA
one	ONEIDA
oni	ONIN
onj	ONJOB
onn	ONABASULU
ono	ONONDAGA
onp	SARTANG
ons	ONO
onu	UNUA
onw	OLD_NUBIAN
ood	TOHONO_OODHAM
oon	ONGE
opa	OKPAMHERI
opk	KOPKAKA
opm	OKSAPMIN
opo	OPAO
opt	OPATA
opy	OFAYE
ora	OROHA
orc	ORMA
ore	OREJON
org	ORING
orh	OROQEN
oro	OROKOLO
orr	ORUMA
ort	ORIYA_KOTIA
oru	ORMURI
orw	ORO_WIN
orx	ORO
ory	ORIYA
orz	ORMU
osa	OSAGE
oss	OSSETIAN
osx	OLD_SAXON
otd	KADORIH
ote	OTOMI_MEZQUITAL
otk	OLD_TURKIC
otl	TILAPA_OTOMI
otm	OTOMI_DE_EL_BAILE
otn	SANTA_ANA_HUEYTLALPAN_OTOMI
otq	OTOMI_QUERETARO
otr	UTORO
ott	OTOMI_TEMOAYA
otu	OTUKE
otw	OTTAWA
otx	TEXCATEPEC_OTOMI
oty	OLD_TAMIL
otz	OTOMI_DE_IXTENCO
oub	GLIO_OUBI
oum	OUMA
owi	OWINIGA
oyb	OI
oyd	OYDA
oym	WAYAMPI
ozm	KOONZIME
pab	PARESI
pac	PACOH
pad	PAUMARI
pae	PAGIBETE
paf	PARANAWAT
pag	PANGASINAN
pah	TENHARIM
pai	PE
pak	PARAKANA
pam	KAPAMPANGAN
pan	PUNJABI_MAJHI
pao	NORTHERN_PAIUTE
pap	PAPIAMENTO
paq	PARYA
par	PANAMINT
pas	PAPASENA
pau	PALAUAN
pav	PAKAANOVA
paw	PAWNEE
pay	PECH
paz	PANKARARU
pbb	PAEZ
pbe	POPOLOCA_METZONTLA
pbf	POPOLOCA_DE_SAN_VICENTE_COYOTEPEC
pbg	PARAUJANO
pbh	ENAPA_WOROMAIPU
pbi	PODOKO
pbl	MAK_NIGERIA
pbn	KPASAM
pbo	PAPEL
pbr	PANGWA
pbs	CENTRAL_PAME
pbu	NORTHERN_PASHTO
pbv	PNAR_JOWAI
pby	PYU
pcb	PEAR
pce	DEANG
pcf	PALIYAN
pci	PARJI
pcj	PARENGA
pck	PAITE
pcl	PARDHI
pcm	NIGERIAN_PIDGIN
pcn	PITI
pda	PONDOMA
pdo	PADOE
pdt	PLAUTDIETSCH
pdu	KAYAN
peb	POMO_EASTERN
ped	PAY
pef	POMO_NORTHEASTERN
peg	PENGO
peh	BONAN
pei	CHICHIMECO
pej	POMO_NORTHERN
pem	PHENDE
peo	OLD_PERSIAN
pep	PEREMKA
peq	SOUTHERN_POMO
pfe	PEERE
pga	JUBA_ARABIC
pgg	PANGWALI
pgi	PAGI
pgk	REREP
pgs	PANGSENG
pgu	PAGU
pha	PA_HNG
phg	KATU
phn	PHOENICIAN
pho	PHUNOI
phq	PHANA
phr	PAHARI_POTWARI
pia	PIMA_BAJO
pib	YINE
pic	PINJI
pid	PIAROA
pif	PINGELAPESE
pih	PITKERN
pil	YOM
pim	POWHATAN_UnnamedInSource
pin	PIAME
pio	PIAPOCO
pip	PERO
pir	PIRATAPUYO
pis	PIJIN
pit	PITTA_PITTA
piu	PINTUPI
piv	PILENI
piw	PIMBWE
pix	PIU
pjt	WANGKA_WIRU
pkg	PAK_TONG
pko	POKOT
pkp	PUKAPUKA
pkt	MALIENG
pku	PAKU
pla	TANI
plb	POLONOMBAUK
ple	PALUE
plg	PILAGA
plh	PAULOHI
pli	PALI
pll	PALAUNG_SHWE
pln	PALENQUERO
plo	OLUTA_POPOLUCA
plq	PALAIC
plr	PALAKA
plu	PALIKUR
plv	SOUTHWEST_PALAWANO
ply	PALIU
pmb	PAMBIA
pmd	PALLANGANMIDDANG
pme	PWAAMEI
pmf	BAREE
pmi	JIULONG_PUMI
pml	LINGUA_FRANCA
pmm	POMO
pmn	PAM
pmo	POM
pmq	NORTHERN_PAME
pmr	PAYNAMAR
pmt	TUAMOTUAN
pmw	PLAINS_MIWOK
pnb	WESTERN_PANJABI_SHAHPUR
pne	WESTERN_PENAN
png	PONGU
pnh	PENRHYN
pnl	PALEN
pno	HUARIAPANO
pnq	PANA
pnr	PANIM
pnw	PANYTYIMA
pny	PINYIN
poe	POPOLOCA_SAN_JUAN_ATZINGO
poh	POQOMCHI_WESTERN
poi	SOTEAPAN_ZOQUE
pol	POLISH
pom	SOUTHEASTERN_POMO
pon	POHNPEIAN
poo	POMO_CENTRAL
poq	TEXISTEPEC_ZOQUE
por	PORTUGUESE
pos	SAYULA_POPOLUCA
pot	POTAWATOMI
pov	GUINEA_BISSAU_CRIOULO
pox	POLABIAN
poy	POGOLO
ppe	PAPI
ppi	PAIPAI
ppk	UMA
ppl	PIPIL
ppm	PAPUMA
ppo	FOLOPA
ppq	PEI
pps	SAN_LUIS_TEMALACAYUCA_POPOLOCA
ppt	PARE
ppu	PAPORA
pqa	PAANCI
pqm	PASSAMAQUODDY_MALISEET_UnnamedInSource
prc	PARACHI
pre	PRINCIPENSE
prg	OLD_PRUSSIAN
pri	PAICI
prm	KIBIRI
prn	PRASUNI
prq	CAMPA_DE_PERENE
prr	PURI
prs	EASTERN_FARSI
prw	PARAWEN
prx	PURIK
psa	AWYU_ASUE
psm	PAUSERNA
psn	PANASUAN
psq	PASI
pss	KAULONG
psw	PORT_SANDWICH
pth	PATAXO
ptn	PATANI
pto	ZOE
ptp	PATEP
ptr	PIAMATSINA
ptv	PORT_VATO
pue	GUNUNA_KUNE
pug	PHWO
pui	PUINAVE
pum	PUMA
puo	KSINMUL
pup	PULABU
puq	PUQUINA
pur	PURUBORA
puu	PUNU
puw	PULUWATESE
pux	PUARE
pwa	PAWAIA
pwg	GAPAPAIWA
pwi	PATWIN
pwm	MOLBOG
pwn	PAIWAN
pwo	KAREN_PWO_WESTERN
pye	KRUMEN_PYE
pym	FYEM
pyn	POYANAWA
pyx	TAMAN_MYANMAR
qua	QUAPAW
qub	HUANUCO
quc	KICHE
qui	QUILEUTE
quk	QUECHUA_CHACHAPOYAS
qul	CURVA
qum	SIPAKAPENSE
qun	QUINAULT
qus	QUECHUA_ARGENTINA
quv	SACAPULTECO_SACAPULAS_CENTRO
quw	SERENA
quy	QUECHUA_AYACUCHO
quz	CUZCO_GNL
qva	QUECHUA_DE_AMBO_HUANUCO_PASCO_PASCO
qvc	CHETILLA
qvi	QUECHUA_IMBABURA
qvj	QUICHUA_LOJA
qvo	QUECHUA_NAPO_LOWLAND
qvp	QUECHUA_PACARAOS
qvs	QUECHUA_SAN_MARTIN
qvy	QUEYU
qvz	QUICHUA_BOLIVAR_CACHISAGUA
qwa	YANAC
qwh	QUECHUA_HUAYLAS_ANCASH
qxa	QUECHUA_ANCASH_CHIQUIAN
qxh	QUECHUA_HUANUCO_PANAO
qxo	CHACPAR
qxq	QASHQAI
qxu	QUECHUA_AREQUIPA_UNION
qxw	QUECHUA_HUANCA_SHAUSHA
raa	DUNGMALI
rab	CAMLING
rac	RASAWA
rad	RADE
raf	WESTERN_MEOHANG
rag	LOGOOLI
rah	RABHA
rai	RAMOAAINA
ral	RALTE
ram	APANIEKRA
rap	RAPA_NUI
rar	RAROTONGAN
ras	TEGALI
rau	RAUTE
rav	SAMPANG
raw	RAWANG
rax	RANG
ray	RAPA
raz	RAHAMBUU
rbl	DARAGA
rcf	REUNIONNAIS
rea	RERAU
ree	REJANG_KAYAN
reg	REGI_TANZANIA
rei	RELI
rej	REJANG
rel	RENDILLE
ren	RENGAO
res	RESHE
rga	RORIA
rgk	JOHARI
rgn	ROMAGNOL
rgr	RESIGARO
rhp	YAHANG
ria	RIANG
rim	NYATURU
rin	NUNGU
rit	RITHARNGU
rji	RAJI
rjs	RAJBANSHI
rkb	RIKBAKTSA
rkh	MANIHIKI
rkm	MARKA
rma	RAMA
rmb	RAINBARNGO
rmd	TRAVELLER_DANISH
rme	ANGLOROMANI
rmf	FINNISH_ROMANI
rmg	NORWEGIAN_ROMANI
rmi	LOMAVREN
rmk	ROMKUN
rmm	ROMA
rmp	REMPI
rmq	CALO
rmt	DOMARI
rmu	SWEDISH_ROMANI
rmw	WELSH_ROMANI
rmy	VLAX_ROMANI
rmz	MARMA
rnd	RUUND
rng	RONGA
rnl	RANGLONG
rnn	RON
rnp	RONGPO
rnw	RUNGWA
rob	TAE
rod	ROGO
roe	ROINJI
rof	ROMBO
rog	NORTHERN_ROGLAI
ron	ROMANIAN
roo	ROTOKAS
rop	NGUKURR_BAMYILI_CREOLE
rou	RUNGA
rpn	REPANBITIP
rpt	RAPTING
rri	RIRIO
rro	RORO
rth	RATAHAN
rtm	ROTUMAN
rtw	RATHAWI
ruf	LUGURU
rug	ROVIANA
rui	RUFIJI
ruk	CE
run	RUNDI
ruq	ROMANIAN_MEGLENO
rus	RUSSIAN
rut	RUTUL
rwa	RAWO
rwo	RAWA
rwr	MARWARI
ryn	NORTHERN_AMAMI_OSHIMA
rys	YAEYAMA
saa	SABA
sab	BUGLERE_MURIRE
sac	FOX
sad	SANDAWE
sae	SABANE
saf	SAFALIBA
sag	SANGO
sah	SAKHA
saj	SAHU
sak	SAKE
sao	SAUSE
sar	SARAVEKA
sas	SASAK
sat	SANTALI
sav	SAFEN
saw	SAWUJ
sax	SA
say	SAYA
saz	SAURASHTRA
sba	NGAMBAY
sbb	SIMBO
sbc	BUJAN
sbd	SOUTHERN_SAMO
sbe	SALIBA_PAPUA_NEWGUINEA
sbf	SHABO
sbg	SEGET
sbh	SORI_HARENGAN
sbi	SETI
sbk	SAFWA
sbl	SAMBAL_BOTOLAN
sbm	SAGALA
sbo	SABUM
sbp	SANGU
sbq	SILEIBI
sbs	MBALANGWE
sbt	KIMKI
sbu	TOD
sbw	SIMBA
sbz	SARA_KABA
scb	RUC
sce	SANTA_MONGOLIAN
sci	UPCOUNTRY_SRI_LANKA_MALAY
sck	SADRI
scn	SICILIAN_UnnamedInSource
sco	SCOTS
scp	HELAMBU_SHERPA
scq	SAOCH
scs	HARE
scv	SHENI
scw	SHA
sda	SADAN
sdb	GORANI_SABAKI
sdc	SASSARESE
sde	SURUBU
sdg	SAVI
sdh	SOUTHERN_KURDISH
sdj	SUUNDI
sdk	SOS_KUNDI
sdn	GALLURESE_SARDINIAN
sdo	BUKAR_SADONG_BIDAYUH
sdp	SHERDUKPEN
sds	SENED
sdu	SARUDU
sdz	SALLANDS
sea	SEMAI
sec	SECHELT
sed	SEDANG
see	SENECA
sef	SENUFO_CEBAARA
seg	SEGEJU
seh	SENA
sei	SERI
sej	SENE
sek	SEKANI
sel	SELKUP
sen	NANERGE
sep	SENUFO_SICITE
seq	SENARA_SENOUFU
ser	SERRANO
ses	KOROBORO_SENNI
set	SENTANI
seu	SERUI_LAUT
sew	SEWA_BAY
sey	SECOYA
sga	OLD_IRISH
sgc	KALENJIN
sgd	SURIGAONON
sge	SEGAI
sgh	SHUGHNI
sgi	NIZAA
sgp	SINGPHO
sgr	SANGISARI
sgz	SURSURUNGA
sha	SHALL
shb	NINAM
she	SHEKO
shg	SHUA
shh	SHOSHONI
shi	TASHELHIT_IDA_USEMLAL
shj	SHATT
shk	SHILLUK
shn	SHAN
sho	SHANGA
shr	SHI
shs	SHUSWAP
sht	SHASTA
shv	SHEHRI
shw	SHIRUMBA
shx	SHE
shy	CHAOUI
sia	AKKALA_SAMI
sib	SEBOP_KENYAH
sid	SIDAMO
sif	SIAMOU
sig	PAASAAL
sii	SHOM_PENG
sij	NUMBAMI
sil	SISAALA_TUMULUNG
sim	MENDE_PNG
sin	SINHALA
sip	SIKKIMESE
siq	SUNIA
sir	SIRI
sis	SIUSLAW
siu	SINAGEN
siw	MOTUNA
six	SUMAU
siy	SIVANDI
siz	SIWI
sjd	KILDIN_SAAMI
sjg	ASSANGORI
sjm	MAPUN
sjo	XIBE
sjr	SIAR
sjs	SENHAJA_DE_SRAIR
sjw	SHAWNEE
skb	SAEK
skc	MA_MANDA
skd	S_SIERRA_MIWOK
ske	SEKE
skf	MEKENS
skh	SICHULE
ski	SIKA
skj	TANGBE
skm	KUTONG_SAKAM
skq	SININKERE
skr	SERAIKI
skt	SAKATA
sku	SAKAO
skv	SKOU
sky	SIKAIANA
skz	SEKAR
slc	SALIBA_COLUMBIA
sld	SISAALA_BURKINA_FASO
sle	SHOLAGA
slh	PUGET_SALISH
sli	LOWER_SILESIAN
slk	SLOVAK
sll	SALT_YUI
slm	PANGUTARAN_SAMA
sln	SALINAN
slp	LAMAHOLOT_ILE_MANDIRI
slr	SALAR
slu	SELARU
slv	SLOVENIAN
slw	SIALUM
sly	SELAYAR
smb	SIMBARI
smc	SOM
smf	AUWE
smj	LULE_SAAMI
smk	BOLIANO
sml	SAMAL
smn	INARI_SAAMI
smo	SAMOAN
smq	SAMO
smr	SIMALUR
sms	SKOLT_SAAMI
smw	SUMBAWA
smx	SAMBA
smy	SEMNANI
sna	SHONA
snc	SINAUGORO
snd	SINDHI
sne	BIDAYUH_BAU
snf	NOON
sni	SENSI
snk	SONINKE
snl	SANGIL
snn	SIONA
snp	SIANE
snq	ISANGU
snr	SIHAN
snu	SENGI
snv	SAABAN
snw	SELE
snx	SAM
sny	SANIO
snz	SINSAURU
sob	SOBEI
soc	ESO_YALEMBA
soh	AKA
sok	SOKORO
sol	SOLOS
som	SOMALI
soo	SONGO
soq	KANASI
sor	SOMRAI
sos	SEEKU
sot	SOTHO_SOUTHERN
sou	SONGKHLA_THAI
sow	WAINA
sox	SO
soy	MOYOBE
spa	SPANISH
spb	SEPA_INDONESIA
spc	SAPE
spd	SAEP
spe	SEPA_PAPUA_NEW_GUINEA
spi	SAPONI
spk	SENGO
spl	SELEPET
spm	SEPEN
spo	SPOKANE
spp	SENOUFO_SUPYIRE
sps	TAIOF
spt	SPITI_BHOTI
spu	SAPUAN
spy	SABAOT
sqa	SHAMA
sqh	SHAU
sqo	SORKHEI
sqq	SU
sqt	SOQOTRI
squ	SQUAMISH
sra	SARUGA
srb	SORA
src	SARDINIAN_LOGUDARESE
srf	SIRAK
srh	SARIKOLI
sri	SIRIANO
srl	SABERI
srm	SARAMACCAN
srn	SRANAN_TONGO
sro	SARDINIAN_CAMPIDANESE
srq	SIRIONO
srs	SARCEE
sru	SURUI_DO_RONDONIA
srv	SOUTHERN_SORSOGON
srw	SERUA
sry	SERA
srz	SHAHMIRZADI
ssb	SIBUTU_SOUTHERN_SAMA
ssd	SIROI
sse	BALANGINGI_SAMA
ssf	THAO
ssg	SEIMAT
ssi	SANSI
ssj	SAUSI
ssl	SISAALA_WESTERN
ssm	SEMNAM
ssn	WAATA
sso	SISSANO
ssq	SOA
sst	SINASINA
ssw	SWATI
ssx	SAU
ssy	SAHO
ssz	SENGSENG
stf	SETA
sti	STIENG
stj	SAMO_MATYA
stk	ARAMMBA
stl	STELLINGWERFS
stn	SANTA_ANA_OWA
sto	STONEY
stp	SOUTHERN_TEPEHUAN
str	SALISH_STRAITS
sts	SHUMASHTI
stv	SILTE
stw	SATAWALESE
sua	SULKA
sub	SUKU
suc	SUBANON_SIOCON
sue	SUENA
sug	WAGARABAI
sui	SUKI
suk	SUKUMA
sun	SUNDANESE
suo	BOUNI
sur	MWAGHAVUL
sus	SUSU
sut	SUBTIABA
suv	PUROIK
suw	SUMBWA
sux	SUMERIAN
suy	SUYA
suz	SUNWAR
sva	SVAN
svb	ULAU
svc	VINCENTIAN_CREOLE
sve	SERILI
svs	SAVOSAVO
swe	SWEDISH
swf	SERE
swg	SWABIAN
swh	SWAHILI
swi	SUI
swj	SIRA
swk	MALAWI_SENA
swm	SAMOSA
swn	FOQAHA
swp	SUAU
swq	SHARWA
swr	SAWERU
swt	SAWILA
swv	SHEKHAWATI
sww	SOWA
swy	SARWA
sxb	SUBA
sxe	SIGHU
sxg	SHIXING
sxk	YONCALLA
sxm	SAMRE
sxn	SANGIR
sxr	SAAROA
sxu	SAXON_UPPER
sya	SIANG
syb	SUBANUN_SINDANGAN
syc	CLASSICAL_SYRIAC
syi	SEKI
syk	SUKUR
syl	SYLHETI
sym	MAYA_SAMO
sys	SINYAR
syw	KAGATE
syx	OSAMAYI
sza	SEMELAI
szc	SEMAQ_BERI
sze	SEZE
szg	SENGELE_MBELO
szp	INANWATAN
szw	SAWAI_UnnamedInSource
taa	LOWER_TANANA
tac	LOWLAND_TARAHUMARA
tad	TAUSE
tae	TARIANA
taf	TAPIRAPE
tag	ORIG
tah	TAHITIAN
taj	EASTERN_TAMANG
tak	TALA
tal	TAL
tam	TAMIL
tan	TANGALE
tao	YAMI
taq	TAMASHEQ
tar	CENTRAL_TARAHUMARA
tat	TATAR
tau	UPPER_TANANA
tav	TATUYO
tax	TEMKI
tay	ATAYAL
taz	TOCHO
tba	AIKANA
tbc	TAKIA
tbd	KAKI_AE
tbf	MANDARA
tbg	N_TAIRORA
tbh	THURAWAL
tbj	TIANG
tbk	TAGBANWA_KALAMIAN
tbm	TAGBU
tbo	TAWALA
tbr	KURONDI
tbs	TANGUAT
tbu	TUBAR
tbv	TOBO
tbx	SAMBIO
tby	TABARU
tbz	DITAMMARI
tca	TIKUNA
tcb	TANACROSS
tcc	DATOOGA_DIALECT_6
tcd	TEGBO
tce	SOUTHERN_TUTCHONE
tcf	TLAPANEC_MALINALTEPEC
tcg	TAMAGARIO
tck	TCHITCHEGE
tcm	TANAHMERAH
tcq	KAIY
tcs	TORRES_STRAIT_CREOLE
tct	TEN
tcx	TODA
tcy	TULU_INDIA
tcz	CHIN_THADO
tdc	EMBERA_TADO
tde	TIRANIGE_DIGA_DOGON
tdf	TARIANG
tdg	WESTERN_TAMANG
tdh	THULUNG
tdi	TOMADINO
tdj	TAJIO
tdk	TAMBAS
tdl	TAPSHIN
tdm	TARUMA
tdn	TONDANO
tdo	TEME
tdr	TODRAH_UnnamedInSource
tds	DOUTAI
tdt	TETUN_DILI
tdv	TORO
tea	TEMIAR
tec	TERIK
ted	KRUMEN_TEPO
tee	TEPEHUA_HUEHUETLA
tef	TERESSA
teg	NORTHERN_TEKE
teh	TEHUELCHE
tei	TORRICELLI
tel	TELUGU
teo	TESO
tep	TEPECANO
teq	TEMEIN
ter	TERENA
tes	TENGGER_NGADAS
tet	TETUN
teu	TEPES
tex	TENNET
tey	TULISHI
tfo	TEFARO
tfr	TERIBE
tft	TERNATE
tga	SAGHALA
tgc	TIGAK
tgd	CIWOGAI
tge	EASTERN_TAMANG
tgf	CHALIKHA
tgj	NISI_TAGIN
tgk	TAJIK
tgl	TAGALOG
tgo	SUDEST
tgp	TANGOA
tgq	TRING
tgs	NUME
tgt	CENTRAL_TAGBANWA
tgu	TANGGU
tgw	SENOUFO_TAGWANA
tgx	TAGISH
tgy	TOGOYO
tha	THAI
thd	THAYORE
the	CHITWAN
thf	THANGMI
thk	THARAKA
thl	DANG
thm	THAVUNG_SO
thp	THOMPSON
thq	MORANG
thr	RANA
ths	THAKALI
thv	TAMAHAQ_TAHAGGART
thy	THA
thz	TAMAJEQ_TAYART_AIR
tic	TIRO
tif	TIFAL
tig	TIGRE
tih	TIMUGON_MURUT
tii	TIENE
tij	TILUNG
tik	TIKAR
til	TILLAMOOK
tim	TIMBE
tin	TINDI
tio	TEOP
tiq	CEFO
tir	TIGRINYA
tiv	TIV
tiw	TIWI
tix	TIWA_SOUTHERN
tiy	TIRURAY
tjg	TUNJUNG
tji	NORTHERN_TUJIA
tjm	TIMUCUA
tjn	TONJON
tkd	TUKUDEDE
tke	TAKWANE
tkl	TOKELAU
tkm	TAKELMA
tkn	TOKUWASE
tkp	TIKOPIA
tkq	TEE
tkr	TSAKHUR
tks	SOUTHERN_TATI
tku	TOTONAC_UPPER_NEXACA
tkw	TEANU
tkx	TANGKO
tlc	TOTONAC_MISANTLA
tld	TALAUD
tlf	TELEFOL
tlg	TOFANMA
tli	TLINGIT
tlj	TALINGA_BWISI
tlk	TALOKI
tll	TETELA
tlm	TOLOMAKO
tlo	JOMANG
tlp	TOTONAC_FILOMENA_MATA
tls	TAMBOTALO
tlu	TULEHU
tlv	SOBOYO
tly	TALYSH
tma	TAMA
tmb	KATBOL
tmc	TUMAK
tmd	HARUAI
tmi	TUTUBA
tmj	SAMAROKENA_TOMAYO
tml	TAMNIM_CITAK
tmo	TEMOQ
tmq	TUMLEO
tmr	ACHAEMENID_ARAMAIC
tms	TIMA
tmt	TASMATE
tmu	IAU
tmw	TEMUAN
tmy	TAMI
tna	TACANA
tnc	TANIMUCA_RETUARA
tnh	MAIANA
tni	TANDIA
tnm	TABLA
tnn	NORTH_TANNA
tnq	TAINO
tnr	BEDIK
tnt	TONTEMBOAN
tnv	TANGCHANGYA
tnw	TONSAWANG
tnx	TANEMA
tnz	TONGA
tob	TOBA
tod	TODE
toh	TONGA_AFRICA
toj	TOJOLABAL
tol	TOLOWA
tom	TOMBULU
ton	TONGAN
too	XICOTEPEC_TOTONAC
top	PAPANTLA_TOTONAC
toq	TOPOSA
tor	TOGBO_VARA_BANDA
tos	TOTONAC_HIGHLAND
tov	UPPER_TAROMI
tow	JEMEZ
toy	TOPOIYO
toz	TO
tpa	TAUPOTA
tpc	AZOYU_TLAPANEC
tpe	TIPPERA_TONGPAI
tpf	TARPIA
tpg	KULA
tpi	TOK_PISIN
tpj	TAPIETE
tpl	TLACOAPA_MEPHAA
tpn	TUPINAMBA
tpp	TEPEHUA_PISA_FLORES
tpr	TUPARI
tpt	TEPEHUA_TLACHICHILCO
tpu	TAMPUAN
tpx	MEPHAA_ACATEPEC
tpy	TRUMAI
tqb	TEMBE
tql	LEHALI
tqo	TOARIPI
tqq	TUNNI
tqu	MBANIATA
tqw	TONKAWA
trb	TEREBU
trc	TRIQUI_COPALA
trd	TURI
trg	LISHAN_DIDAN
trh	TURAKA
tri	TIRIYO
trj	TORAM
trm	TREGAMI
trn	TRINITARIO
tro	NAGA_TARAO
trq	TRIQUI_SAN_MARTIN_ITUNYOSO
trr	TAUSHIRO
trs	TRIQUI_CHICAHUAXTLA
trt	TUNGGARE
tru	TUROYO
trv	SEDIQ
trw	TORWALI
trz	TORA
tsa	TSAANGI
tsb	TSAMAI
tsc	TSHWA
tsd	TSAKONIAN
tsg	TAUSUG
tsh	TSUVAN
tsi	COAST_TSIMSHIAN
tsj	TSHANGLA
tsn	TSWANA
tso	TSONGA
tsp	NORTH_TOUSSIAN
tsr	AKEI
tsu	TSOU
tsv	TSOGO
tsw	TSISHINGINI
tsx	MUBAMI
tsz	PUREPECHA
tta	TUTELO
ttb	TIBA
ttd	TAUADE
tte	BWANABWANA
ttf	BONEK
tti	TOBATI
ttj	TOORO
ttk	TOTORO
ttm	NORTHERN_TUTCHONE
ttn	TOWEI
ttq	TETSERRET
ttr	TERA
ttu	TORAU
ttv	SIVISA_TITAN
tty	SIKARITAI
tua	WIARUMUS
tub	TUBATULABAL
tuc	MUTU
tud	TUXA
tue	TUYUCA
tuf	TUNEBO
tug	TUNIA
tuh	TAULIL
tui	TUPURI
tuk	TURKMEN
tul	TULA
tun	TUNICA
tuo	TUCANO
tuq	TEDAGA
tur	TURKISH
tus	TUSCARORA
tuu	TUTUTNI
tuv	TURKANA
tux	TUXINAWA
tuy	NORTH_TUGEN
tuz	TURKA
tva	VAGHUA
tvd	TSUVADI
tve	TEUN
tvm	TELA_MASBUAR
tvo	TIDORE
tvs	TAVETA
tvt	TUTSA
tvu	TUNEN
tvw	SEDOA
twa	TWANA
twc	TESHENAWA
twd	TWENTS
twg	BLAGAR_TEREWENG
twl	TAWARA
twn	TWENDI
twq	TASAWAQ
twt	TURIWARA
twu	TERMANU
tww	TUWARI
twy	TAWOYAN
txb	TOCHARIAN_B
txe	TOTOLI
txg	TANGUT
txi	IKPENG
txm	TOMINI
txo	TOTO
txs	TONSEA
txt	CITAK
txu	KAYAPO
txx	TATANA
txy	MALAGASY_TANOSY_TOLAGNARO
tya	TAUYA
tye	KYENGA
tyi	WESTERN_TEKE_TSAAYI
tyn	KOMBAI
tyr	TAI_DAENG
tyu	KUA
tyv	TUVAN
tyz	TAY
tzn	TUGUN
tzx	TABRIAK
uba	UBANG
ubi	UBI
ubr	UBIR
ubu	UMBU_UNGU
uby	UBYKH
uda	UDA
ude	UDEHE
udi	UDI
udj	UJIR
udl	WUZLAM
udm	UDMURT
udu	UDUK
ufi	UFIM
uga	UGARITIC
uge	UGHELE
ugo	GONG
uha	UHAMI
uig	UYGHUR
uji	JIJILI
uka	KABURI
ukg	UKURIGUMA
ukq	UKWA
ukr	UKRAINIAN
uku	UKUE
ukw	UKAWANI_ABOH_NDONI
ulc	ULCHA
ule	LULE_AND_TONOCOTE
ulf	USKU
uli	ULITHIAN
ulk	MERIAM
ull	ULLATAN
ulw	ULWA
uma	UMATILLA_SAHAPTIN
umb	UMBUNDU
umg	UMBUYKAMU
umm	UMON
umo	UMOTINA
umr	UMBUGARLA
ums	PENDAU
umu	DELAWARE_MUNSEE
una	ONANK
une	UNEME
ung	NGARINYIN
uni	UNI
unk	ENAWENE_NAWE
unm	UNAMI_UnnamedInSource
unr	MUNDARI
upi	UMEDA
ura	URARINA
urb	URUBU_KAAPOR
urc	URNINGANGG
urd	URDU
ure	UCHUMATAQU
urg	URIGINA
urh	URHOBO
urk	URAK_LAWOI
urn	URUANGNIRIN
uro	URA_PNG
urr	LEHALURUP
urv	URUAVA
urw	USINO
urx	URIMO
ury	ORYA
urz	URUEWAUWAU
usa	USARUFA
ush	USHOJO
usi	USUI
usk	USAKADE
usp	USPANTEKO
usu	USU
ute	UTE_SOUTHERN_PAIUTE
utu	UTU
uur	URA
uuu	U
uve	WEST_UVEAN
uvh	URI
uvl	LOTE
uwa	KUKU_UWANH
uya	DOKO_UYANGA
uzn	UZBEK
uzs	SOUTHERN_UZBEK
vaa	VAAGRI_BOLI
vae	VALE
vaf	VAFSI
vag	VAGALA
vah	VARHADI_NAGPURI
vai	VAI
vaj	O_KUNG
val	BUASI
vao	VAO
var	HUARIJIO
vas	VASAVI
vav	WARLI
vay	HAYU
vbb	SOUTHEAST_BABAR
ved	VEDDA
vem	VEMGO_MABAS
ven	VENDA
vep	VEPS
ver	MOMI
vie	VIETNAMESE
vif	VILI
vig	VIEMO
vil	VILELA
vin	VINZA
viv	IDUNA
vkj	KUJARKE
vkl	KULISUSU
vkm	KAMAKAN
vko	KODEOHA
vkp	KORLAI
vku	KURRAMA
vlp	VALPEI
vma	MARTUTHUNIRA
vmb	MBABARAM
vme	EAST_MASELA
vmg	MINIGIR
vmp	SAN_MIGUEL_SOYOLTEPEC
vmy	SAN_BARTOLOME_AYAUTLA
vnk	VANO
vnm	VINMAVIS
vnp	VUNAPU
vot	VOTIC
vra	VERAA
vro	ESTONIAN_VORO
vrs	VARISI
vrt	BURMBAR
vto	VITOU
vun	WUNJO
vut	VUTE
vwa	AWA
wac	WISHRAM
wad	WANDAMEN
wah	WATUBELA
waj	WAFFA
wal	WOLAYTTA
wam	WAMPANOAG_NATICK
wan	WAN
wao	WAPPO
wap	WAPISHANA
waq	WAGIMAN
war	WARAY_WARAY
was	WASHO
wau	WAURA
wav	WAKA
waw	WAIWAI
wax	WATAM
way	WAYANA
waz	WAMPUR
wba	WARAO
wbb	WABO
wbe	WARITAI
wbf	WARA
wbh	WANDA
wbi	WANJI
wbj	ALAGWA
wbk	WAIGALI
wbm	WA
wbp	WARLPIRI
wbq	WADDAR
wbr	WAGDI
wbv	WAJARRI
wbw	WOI
wca	YANOMAMI
wdd	WANDJI
wdg	WADAGINAM
wdj	WADJIGINY
wed	WEDAU
weh	WEH
wei	WERE
wer	WERI
wes	KAMTOK
wet	PERAI
wew	WEJEWA
wga	WAGAYA
wgg	WANGGANGURU
wgi	MIDDLE_WAHGI
wgo	AMBEL
wgu	WIRANGU
wgy	WARGAMAY
whg	NONDUGL
wib	SOUTHERN_TOUSSIAN
wic	WICHITA
wig	WIK_NGATHAN
wii	WIAKI
wim	WIK_MUNGKAN
win	WINNEBAGO
wir	WIRAFED
wiu	WIRU
wiv	VITU
wiy	WIYOT
wja	WAJA
wji	WARJI
wka	KWADZA
wkw	DUUNGIDJAWU
wla	WALIO
wle	WALANI_SILTE
wlg	GUNBALANG_WARLANG
wlk	WAILAKI
wll	WALI_SUDAN
wln	WALLOON
wlo	WOLIO
wlr	WAILAPA
wls	WALLISIAN_EAST_UVEAN
wlu	WULIWULI
wlv	WICHI_LHAMTES_VEJOZ
wlw	PYRAMID_WODO
wlx	WALI
wly	WALING
wmb	WAMBAYA
wmc	WAMAS
wmd	MAMAINDE
wme	WAMBULE
wmg	MUNYA
wmh	WAIMAA
wmo	WAM
wms	WAMBON
wmt	WALMAJARRI
wmw	MWANI
wmx	WOMO
wnb	WANAMBRE
wnc	WANTOAT
wnd	WANDARANG
wne	WANECI
wng	WANGGOM
wni	NZWANI
wnk	WANUKAKA
wno	WANO
wnp	WANAP
wnu	USAN
wnw	WINTU
woa	TYARAITY
woc	WOGEO
wod	WOLANI
woe	WOLEAIAN
wof	WOLOF_GAMBIAN
wog	WOGAMUSIN
woi	KAMANG
wok	LONGTO
wol	WOLOF
wom	WOM_AFRICA
won	WONGO
woo	MANOMBAI
wos	HANGA_HUNDI
wow	WAWONII
wpc	MAKO
wrb	WARLUWARA
wrg	WARUNGU
wrh	WIRADHURI
wrk	GARAWA
wrm	WARUMUNGU
wrn	WARNANG
wro	WORRORRA
wrp	WAROPEN
wrr	WARDAMAN
wrs	WARIS
wru	WARU
wrv	WARUNA
wrz	WARAY
wsa	WAREMBORI
wsg	ADILABAD_GONDI
wsk	WASKIA
wsv	WOTAPURI_KATARQALAI
wtf	DUMPU
wth	WATHAWURRUNG
wti	BERTA
wtw	WOTU
wub	WUNAMBAL
wud	WUDU
wuh	WUTUN
wul	KINIAGEIMA
wum	WUMBVU
wun	BUNGU
wut	WUTUNG
wuv	WUVULU
wuy	WAUYAI
wwa	WAAMA
wwo	WETAMUT
wwr	WARRWA
www	WAWA
wyb	WANGAAYBUWAN_NGIYAMBAA
wyi	WOIWURRUNG
wym	WYMYSORYS
wyy	WAYAN_FIJIAN
xac	KACHARI
xak	MAKU
xal	KALMYK
xam	KAM_KA_KE
xan	XAMTANGA
xar	KARAMI
xas	KAMAS
xat	KATAWIXI
xau	KWERBA_KAUWERAWET_I
xav	XAVANTE
xaw	KAWAIISU
xbg	BUNGANDITJ
xbi	KOMBIO
xbr	KAMBERA
xch	CHEMAKUM
xcl	ARMENIAN_CLASSICAL
xcm	COMECRUDO
xcn	COTONAME
xcw	COAHUILTECO
xcy	CAYUSE
xda	DARRKINYUNG
xdk	SYDNEY
xed	HDI
xeg	BATWA
xel	KELO
xer	XERENTE
xes	KESAWAI
xet	XETA
xgm	DHARUMBAL
xgu	UNGGUMI
xhe	KHETRANI
xho	XHOSA
xil	ILLYRIAN
xin	XINCA
xir	BAHUANA
xiy	XIPAYA
xka	KALKOTI
xkl	LONG_ANAP_KENYAH
xkq	KORONI
xks	KUMBEWAHA
xkv	QHALAXARZI
xkw	KEMBRA
xkz	KURTOP
xla	KAMULA
xlo	NIPMUCK
xmb	MBOA
xmd	MBEDAM
xmf	MINGRELIAN
xmg	MENGAKA
xmm	MANADONESE
xmt	MATBAT
xmu	KAMOR
xmv	MALAGASY_ANTANKARANA
xmw	MALAGASY_TSIMIHETY
xmy	MAYAGUDUNA
xmz	MORI_BAWAH
xnb	KANAKANABU
xni	NGARIGU
xnn	KANKANAY_NORTHERN
xns	KANASHI
xnz	KENZI
xod	KOKODA_KASUWERI
xog	SOGA
xok	XOKLENG
xom	KOMO
xon	KONKOMBA
xop	KOPAR
xow	KOWAKI
xpb	BEN_LOMOND_CAPE_PORTLAND
xpe	KPELLE_LIBERIA
xpk	KULINA_PANO
xpm	PUMPOKOL
xpo	POCHUTLA_NAHUATL
xpq	MOHEGAN
xpt	PUNTHAMARA
xra	KRAHO
xrb	EASTERN_KARABORO
xre	KREYE
xrn	ARIN
xru	MARRIAMMU
xrw	KARAWA
xsa	SABEAN
xsb	SAMBAL
xse	SEMPAN
xsi	SIO
xsl	SLAVEY
xsm	KASEM
xsn	SANGA
xsp	SILOPI
xsr	SHERPA
xsu	SANUMA
xsy	SAISIYAT
xta	MIXTEC_ALCOZAUCA
xtd	DIUXI_TILANTONGO_MIXTEC
xte	KETENGBAN_BIME
xtn	MIXTEC_NORTHERN_TLAXIACO
xto	TOCHARIAN_A
xua	KURUMBA_ALU
xub	BETTA_KURUMBA
xul	NGUNAWAL
xuo	KUO
xuu	KXOE
xvi	SHEKHANI
xwa	KWAZA
xwe	XWELA_GBE
xwg	KWEGU
xwk	WANGKUMARA
xwr	KWERBA_MAMBERAMO
xww	WEMBA_WEMBA
xxk	KEO
xxt	TAMBORA
xya	YAYGIR
xyb	YANDJIBARA
xyj	MAYI_YAPI
xyk	MAYKULAN
xyt	MAYI_THAKURTI
xyy	YORTA_YORTA
yaa	YAMINAWA
yab	YUHUP
yac	PASS_VALLEY_YALI
yad	YAGUA
yae	YARURO
yaf	YAKA
yag	YAMANA
yah	YAZGULYAM
yai	YAGHNOBI
yaj	BANDA_YANGERE
yak	YAKIMA
yal	YALUNKA
yam	YAMBA
yan	MAYANGNA
yao	YAO
yap	YAPESE
yaq	YAQUI
yar	YABARANA
yas	NUGUNU
yat	YAMBETA
yau	YUWANA
yav	YANGBEN
yaw	YAWALAPITI
yay	AGWAGWUNE
yaz	LOKAA
yba	YALA
ybb	YEMBA
ybe	WEST_YUGUR
ybh	YAKHA
ybi	YAMPHU
ybj	HASHA
ybl	YUKUBEN
ybm	YABEN
ybo	YABONG
ybx	WOSWARI
yby	YABIYUFA
ycl	LOLOPO
ycn	YUCUNA
ydd	YIDDISH_EASTERN
yde	YANGUM_DEY
ydg	YIDGHA
ydk	YOIDIK
yea	RAVULA
yel	YELA_KELA
yer	TAROK
yes	NYANKPA
yet	YETFA
yeu	YERUKULA
yev	YERI
yey	SHIYEYI
yga	MALYANGAPA
ygl	YANGUM_GEL
ygr	YAGARIA
ygw	YAGWOIA
yha	BAHA_BUYANG
yhd	JUDEO_IRAQI_ARABIC
yia	YINGGARDA
yig	DAFANG
yih	YIDDISH_WESTERN
yii	YIDINY
yij	YINDJIBARNDI
yim	NAGA_YIMCHUNGRU
yka	YAKAN
ykg	NORTHERN_YUKAGHIR
yki	YOKE
ykk	YAKAIKEKE
ykm	YAKAMUL
yko	YASA
ykr	YEKORA
yky	YAKOMA
yla	ULWA_PNG
yle	YELETNYE
ylg	YELOGU
yli	ANGGURUK_YALI
yll	YIL
yln	BUYANG
ylr	YALARNNGA
yly	NYALAYU
ymb	YAMPES
yme	YAMEO
yml	IAMALELE
ymm	MAAY
ymo	YANGUM_MON
ymp	YAMAP
ynd	YANDRUWANDHA
yng	YANGO
ynl	YANGULAM
ynn	YANA
yno	YONG
ynq	YENDANG
yns	YANSI
ynu	YAHUNA
yob	YOBA
yog	YOGAD
yoi	YONAGUNI
yom	YOMBE
yon	YONGGOM
yor	YORUBA
yot	YOTI
yox	YORON
yra	YERAKAI
yrb	YAREBA
yre	YAURE
yrk	NENETS
yrl	NHENGATU
yrn	YERONG
yrw	YARAWATA
ysn	SANI_YI
ysr	YUPIK_SIRENIK
yss	YESSAN_MAYO
yub	YUGAMBAL
yuc	YUCHI
yud	JUDEO_TRIPOLITANIAN_ARABIC
yui	YURUTI
yuj	KARKAR_YURI
yuk	YUKI
yul	YULU
yum	YUMA
yun	NIGERIAN_BENA
yup	YUKPA
yuq	YUQUI
yur	YUROK
yut	YOPNO
yuw	NUNGON
yux	SOUTHERN_YUKAGHIR
yuy	SHIRA_YUGUR
yuz	YURACARE
yva	YAWA
yvt	YAVITERO
ywa	KALOU
ywn	YAWANAWA
ywq	WUDING_LUQUAN_YI
ywr	YAWURU
yyu	YAU
zaa	ZAPOTEC_SIERRA_DE_JUAREZ
zab	ZAPOTEC_SAN_LUCAS_QUIAVINI
zac	OCOTLAN_ZAPOTEC
zad	CAJONOS_ZAPOTEC
zae	YARENI_ZAPOTEC
zaf	AYOQUESCO_ZAPOTEC
zag	BERIA
zah	SOOR
zai	ISTHMUS_ZAPOTEC
zaj	ZALAMO
zak	ZANAKI
zaq	ALOAPAM_ZAPOTEC
zav	ZAPOTEC_YATZACHI
zaw	ZAPOTEC_MITLA
zay	ZAYSE_ZERGULLA
zaz	ZARI
zbc	CENTRAL_BERAWAN
zbe	EAST_BERAWAN
zbw	LONG_TERAWAN_BERAWAN
zea	ZEEUWS
zeg	ZENAG
zen	ZENAGA
zgr	MAGORI
zhb	ZHABA
zhw	ZHOA
zia	ZIA
zik	ZIMAKANI_SOUTH_BOAZI
zim	MESME
zin	ZINZA
ziw	ZIGULA
ziz	ZIZILIVAKAN
zka	KAIMBULAWA
zkk	KARANKAWA
zko	KOTT
zkr	MEYOR
zku	KAURNA
zlm	MALAY
zma	MANDA
zmb	ZIMBA
zmc	MARGANY
zmd	MARIDAN
zme	MANGERR
zmf	MFINU
zmj	MARITYABEN
zml	MATNGALA
zmm	MARAMANADJI
zmn	MBANGWE
zmo	MOLO
zmp	MPUONO
zmq	MITUKU
zmr	MARANUNGGU
zms	MBESA
zmt	MARENGAR
zmu	MURUWARI
zmv	PARIMANKUTINMA
zne	ZANDE
zng	MANG
zns	MANGAS
zoc	CHIAPAS_ZOQUE
zoq	AYAPANECO
zor	ZOQUE_RAYON
zos	ZOQUE_FRANCISCO_LEON
zpc	CHOAPAN_ZAPOTEC
zpf	SAN_PEDRO_QUIATONI_ZAPOTEC
zpi	SANTA_MARIA_QUIEGOLANI_ZAPOTEC
zpl	LACHIXIO_ZAPOTEC
zpm	ZAPOTEC_MIXTEPEC
zpn	SANTA_INES_YATZECHI_ZAPOTEC
zpo	AMATLAN_ZAPOTEC
zpq	ZAPOTEC_ZOOGOCHO
zpu	ZAPOTEC_YALALAG
zpx	COATLAN_LOXICHA_ZAPOTEC
zpz	TEXMELUCAN_ZAPOTEC
zrn	ZIRENKEL
zro	ZAPARO
zsa	SIRASIRA
zsr	ZAPOTEC_SOUTHERN_RINCON
zsu	SUKURUM
ztg	XANAGUIA_ZAPOTEC
ztp	ZAPOTEC_LOXICHA
ztq	QUIOQUITANI_QUIERI_ZAPOTEC
zts	TILQUIAPAN_ZAPOTEC
zuh	TOKANO
zul	ZULU
zum	KUMZARI
zun	ZUNI
zwa	ZWAY
zyp	CHIN_ZYPHE
