[console_scripts]
aif2wav=dsbin.music.awa:aif2wav
alacrity=dsbin.music.alacrity:main
backupsort=dsbin.files.backupsort:main
bigfiles=dsbin.files.bigfiles:main
bipclean=dsbin.logic.bipclean:main
bouncefiler=dsbin.logic.bouncefiler:main
bounceprune=dsbin.logic.bounceprune:main
bounces=dsbin.logic.bounces:main
changehostname=dsbin.tools.changehostname:main
changelogs=dsbin.dev.update_changelog:main
checkdeps=dsbin.dev.check_dependencies:main
checkimports=dsbin.dev.check_imports:main
codeconfigs=dsbin.dev.code_configs.code_configs:main
csvfix=dsbin.text.csvfix:main
dmg-encrypt=dsbin.mac.dmg_encrypt:main
dmgify=dsbin.mac.dmgify:main
dockermounter=dsbin.tools.dockermounter:main
dsfish=dsbin.tools.dsfish:main
dsservice=dsbin.tools.dsservice:main
dsupdater=dsbin.updater.updater:main
dsupdater-install=dsbin.updater.install:main
dsver=dsbin.dsver:main
dupefinder=dsbin.files.dupefinder:main
envsync=dsbin.tools.envsync:main
ffgif=dsbin.media.ffgif:main
fftrim=dsbin.media.fftrim:main
foldermerge=dsbin.files.foldermerge:main
hpfilter=dsbin.music.hpfilter:main
impactanalyzer=dsbin.dev.impact_analyzer:main
lsbin=dsbin.lsbin:main
metacopy=dsbin.music.metacopy:main
mp3ify=dsbin.music.mp3ify:main
mshare=dsbin.music.mshare:main
netreset=dsbin.mac.netreset:main
oldprojects=dsbin.logic.oldprojects:main
packageanalyzer=dsbin.dev.package_analyzer:main
pybounce=dsbin.pybounce.main:main
pybumper=dsbin.pybumper.main:main
pycompare=dsbin.text.pycompare:main
pyprojector=dsbin.pyprojector.pyprojector:main
reporun=dsbin.dev.reporun:main
rmp3=dsbin.music.rmp3:main
rsyncer=dsbin.files.rsyncer:main
setmag=dsbin.mac.setmag:main
spacepurger=dsbin.tools.spacepurger:main
ssh-tunnel=dsbin.tools.ssh_tunnel:main
tagreplace=dsbin.dev.tag_replace:main
timestamps=dsbin.mac.timestamps:main
w11renamer=dsbin.text.w11renamer:main
wav2aif=dsbin.music.awa:wav2aif
workcalc=dsbin.workcalc.main:main
wpmusic=dsbin.wpmusic.main:main

