[console_scripts]
alarmclk = pycmd2.system.alarmclock.cli:main
checksum = pycmd2.files.checksum.checksum:main
docdiff = pycmd2.office.doc_diff:cli.app
envjs = pycmd2.envs.env_javascript:cli.app
envpy = pycmd2.envs.env_python:cli.app
envrs = pycmd2.envs.env_rust:cli.app
filedate = pycmd2.files.file_date:cli.app
filelvl = pycmd2.files.file_level:cli.app
folderb = pycmd2.files.folder_backup:cli.app
folderz = pycmd2.files.folder_zip:cli.app
gitadd = pycmd2.git.git_add:cli.app
gitc = pycmd2.git.git_clean:cli.app
gitinit = pycmd2.git.git_init:cli.app
gitpa = pycmd2.git.git_push_all:cli.app
gitre = pycmd2.git.git_restart_tgitcache:cli.app
img2pdf = pycmd2.images.image_to_pdf:cli.app
imggry = pycmd2.images.image_gray:cli.app
llmcli = pycmd2.llama.llama_client:main
llmqnt = pycmd2.llama.llama_quantize:main
llmsvr = pycmd2.llama.llama_server:main
mindnote = pycmd2.office.mindnote.cli:main
mkp = pycmd2.make.make_python:cli.app
pdfc = pycmd2.office.pdf_crypt:cli.app
pdfmrg = pycmd2.office.pdf_merge:cli.app
pdfspl = pycmd2.office.pdf_split:cli.app
pipd = pycmd2.pip.pip_download:cli.app
pipdr = pycmd2.pip.pip_download_req:cli.app
pipf = pycmd2.pip.pip_freeze:cli.app
pipi = pycmd2.pip.pip_install:cli.app
pipio = pycmd2.pip.pip_install_offline:cli.app
pipir = pycmd2.pip.pip_install_req:cli.app
pipr = pycmd2.pip.pip_reinstall:cli.app
pipu = pycmd2.pip.pip_uninstall:cli.app
pipur = pycmd2.pip.pip_uninstall_req:cli.app
pycmd2 = pycmd2.cli:cli.app
ssh-copy-id = pycmd2.network.ssh_copy_id:cli.app
taskk = pycmd2.task.task_kill:cli.app
videoconv = pycmd2.video.video_converter:main
wch = pycmd2.system.which:cli.app
